あれ？	あれ？	あれ？	あれ？
おめめさんどこかしら	おめめさんどこかしら	おめめさんどこかしら	おめめさんどこかしら
さがしてこようかな……	さがしてこようかな……	さがしてこようかな……	さがしてこようかな……
おぼうしあったわ！	おぼうしあったわ！	おぼうしあったわ！	おぼうしあったわ！
おでかけね！	おでかけね！	おでかけね！	おでかけね！
……	……	……	……
あ！	あ！	あ！	あ！
まって！	まって！	まって！	まって！
わるくないもん	わるくないもん	わるくないもん	わるくないもん
あれ！	あれ！	あれ！	あれ！
まいご……？	まいご……？	まいご……？	まいご……？
まいごじゃなかった！	まいごじゃなかった！	まいごじゃなかった！	まいごじゃなかった！
ううーん	ううーん	ううーん	ううーん
なあにあの子......	なあにあの子......	なあにあの子......	なあにあの子......
まだかなあ/きた？/おなかすいた	まだかなあ/きた？/おなかすいた	まだかなあ/きた？/おなかすいた	まだかなあ/きた？/おなかすいた
なんだい！	なんだい！	なんだい！	なんだい！
なにしてるの？	なにしてるの？	なにしてるの？	なにしてるの？
なにもしてないんだよ	なにもしてないんだよ	なにもしてないんだよ	なにもしてないんだよ
へんなの	へんなの	へんなの	へんなの
みせものじゃないんだ、いきな！	みせものじゃないんだ、いきな！	みせものじゃないんだ、いきな！	みせものじゃないんだ、いきな！
おまえひまなのか？	おまえひまなのか？	おまえひまなのか？	おまえひまなのか？
あのなあ	あのなあ	あのなあ	あのなあ
なに？	なに？	なに？	なに？
おまえやることないのか？	おまえやることないのか？	おまえやることないのか？	おまえやることないのか？
えっと、あるよ	えっと、あるよ	えっと、あるよ	えっと、あるよ
じゃーとっとと行きな！	じゃーとっとと行きな！	じゃーとっとと行きな！	じゃーとっとと行きな！
でも、わたしなにをしなきゃいけないんだっけ	でも、わたしなにをしなきゃいけないんだっけ	でも、わたしなにをしなきゃいけないんだっけ	でも、わたしなにをしなきゃいけないんだっけ
わたしが知るもんか！	わたしが知るもんか！	わたしが知るもんか！	わたしが知るもんか！
……	……	……	……
いらっしゃい！	いらっしゃい！	いらっしゃい！	いらっしゃい！
ここなにやさんなの？	ここなにやさんなの？	ここなにやさんなの？	ここなにやさんなの？
何でも売ってるよ！	何でも売ってるよ！	何でも売ってるよ！	何でも売ってるよ！
全部屋さん......？	全部屋さん......？	全部屋さん......？	全部屋さん......？
そうよ！なにが欲しいのかしら？	そうよ！なにが欲しいのかしら？	そうよ！なにが欲しいのかしら？	そうよ！なにが欲しいのかしら？
なにがほしいんだろう……	なにがほしいんだろう……	なにがほしいんだろう……	なにがほしいんだろう……
いよお友よ！	いよお友よ！	いよお友よ！	いよお友よ！
えっ？	えっ？	えっ？	えっ？
なにしてるの？	なにしてるの？	なにしてるの？	なにしてるの？
仮面屋さ！	仮面屋さ！	仮面屋さ！	仮面屋さ！
仮面って何に使うの？	仮面って何に使うの？	仮面って何に使うの？	仮面って何に使うの？
そりゃ被るのさ！	そりゃ被るのさ！	そりゃ被るのさ！	そりゃ被るのさ！
ふーん	ふーん	ふーん	ふーん
おめん欲しいだろ？	おめん欲しいだろ？	おめん欲しいだろ？	おめん欲しいだろ？
うーんちょっとだけ	うーんちょっとだけ	うーんちょっとだけ	うーんちょっとだけ
そうだよな！それじゃあ特におすすめの希望の面！これは5000でいいぞ！	そうだよな！それじゃあ特におすすめの希望の面！これは5000でいいぞ！	そうだよな！それじゃあ特におすすめの希望の面！これは5000でいいぞ！	そうだよな！それじゃあ特におすすめの希望の面！これは5000でいいぞ！
お金いるの？	お金いるの？	お金いるの？	お金いるの？
当然さぁ、お店なんだから！	当然さぁ、お店なんだから！	当然さぁ、お店なんだから！	当然さぁ、お店なんだから！
お金ないときはどうしたらいいの？	お金ないときはどうしたらいいの？	お金ないときはどうしたらいいの？	お金ないときはどうしたらいいの？
金がないんじゃあ仮面は売れないね！とっとといきな！	金がないんじゃあ仮面は売れないね！とっとといきな！	金がないんじゃあ仮面は売れないね！とっとといきな！	金がないんじゃあ仮面は売れないね！とっとといきな！
なんでしらないひととなかよくしなきゃいけないの？	なんでしらないひととなかよくしなきゃいけないの？	なんでしらないひととなかよくしなきゃいけないの？	なんでしらないひととなかよくしなきゃいけないの？
ほんとうはしらないひとこわいのに......	ほんとうはしらないひとこわいのに......	ほんとうはしらないひとこわいのに......	ほんとうはしらないひとこわいのに......
あーあ、すきなものだけがほしいのに......	あーあ、すきなものだけがほしいのに......	あーあ、すきなものだけがほしいのに......	あーあ、すきなものだけがほしいのに......
ほかのこみたいになりたいな......	ほかのこみたいになりたいな......	ほかのこみたいになりたいな......	ほかのこみたいになりたいな......
ねえ、これ	ねえ、これ	ねえ、これ	ねえ、これ
なんだい	なんだい	なんだい	なんだい
これみて。ほしいんじゃないの？	これみて。ほしいんじゃないの？	これみて。ほしいんじゃないの？	これみて。ほしいんじゃないの？
おっ！	おっ！	おっ！	おっ！
みどりで！	みどりで！	みどりで！	みどりで！
ながくて！	ながくて！	ながくて！	ながくて！
ぐねぐねなやつ！	ぐねぐねなやつ！	ぐねぐねなやつ！	ぐねぐねなやつ！
これだいすき！なんでわかったの？	これだいすき！なんでわかったの？	これだいすき！なんでわかったの？	これだいすき！なんでわかったの？
えっ？	えっ？	えっ？	えっ？
わかんない......	わかんない......	わかんない......	わかんない......
きゅうりさんきゅうりさん、うふふ	きゅうりさんきゅうりさん、うふふ	きゅうりさんきゅうりさん、うふふ	きゅうりさんきゅうりさん、うふふ
お面がほしいの？	お面がほしいの？	お面がほしいの？	お面がほしいの？
売れ残りだけど、あげちゃう！	売れ残りだけど、あげちゃう！	売れ残りだけど、あげちゃう！	売れ残りだけど、あげちゃう！
またきてね！	またきてね！	またきてね！	またきてね！
公園だ！	公園だ！	公園だ！	公園だ！
おねえちゃんは行っちゃだめって言ってたけど......	おねえちゃんは行っちゃだめって言ってたけど......	おねえちゃんは行っちゃだめって言ってたけど......	おねえちゃんは行っちゃだめって言ってたけど......
............	............	............	............
あなた、どうしておくちがあかないの？	あなた、どうしておくちがあかないの？	あなた、どうしておくちがあかないの？	あなた、どうしておくちがあかないの？
.........	.........	.........	.........
.........	.........	.........	.........
ねえ、あそばないの？	ねえ、あそばないの？	ねえ、あそばないの？	ねえ、あそばないの？
…………	…………	…………	…………
ねえ！	ねえ！	ねえ！	ねえ！
............	............	............	............
！！	！！	！！	！！
えっなに？	えっなに？	えっなに？	えっなに？
ごあいさつしていい？	ごあいさつしていい？	ごあいさつしていい？	ごあいさつしていい？
なにが？	なにが？	なにが？	なにが？
ごあいさつ！	ごあいさつ！	ごあいさつ！	ごあいさつ！
ごあいさつって？	ごあいさつって？	ごあいさつって？	ごあいさつって？
こ	こ	こ	こ
ん	ん	ん	ん
ち	ち	ち	ち
は～～～！	は～～～！	は～～～！	は～～～！
先生は黙りなさいっていうの。しゃべっていいんでしょ？	先生は黙りなさいっていうの。しゃべっていいんでしょ？	先生は黙りなさいっていうの。しゃべっていいんでしょ？	先生は黙りなさいっていうの。しゃべっていいんでしょ？
しゃべっちゃだめだったの？	しゃべっちゃだめだったの？	しゃべっちゃだめだったの？	しゃべっちゃだめだったの？
ううん！先生いないから！	ううん！先生いないから！	ううん！先生いないから！	ううん！先生いないから！
先生いなくてもだまってたんだ	先生いなくてもだまってたんだ	先生いなくてもだまってたんだ	先生いなくてもだまってたんだ
みんながうるさいっていうから	みんながうるさいっていうから	みんながうるさいっていうから	みんながうるさいっていうから
おしゃべりたのしいよね！	おしゃべりたのしいよね！	おしゃべりたのしいよね！	おしゃべりたのしいよね！
まえはおしゃべりしてくれるひとたくさんいたのにね！	まえはおしゃべりしてくれるひとたくさんいたのにね！	まえはおしゃべりしてくれるひとたくさんいたのにね！	まえはおしゃべりしてくれるひとたくさんいたのにね！
あっはっはっは	あっはっはっは	あっはっはっは	あっはっはっは
ねえ、なにしてるの？	ねえ、なにしてるの？	ねえ、なにしてるの？	ねえ、なにしてるの？
えー？	えー？	えー？	えー？
えっとねー	えっとねー	えっとねー	えっとねー
先生がやりなさいって言ったやつ！	先生がやりなさいって言ったやつ！	先生がやりなさいって言ったやつ！	先生がやりなさいって言ったやつ！
わたしたちけんかいっつもするの！	わたしたちけんかいっつもするの！	わたしたちけんかいっつもするの！	わたしたちけんかいっつもするの！
だから先生がみんなで遊べるからって言ったの	だから先生がみんなで遊べるからって言ったの	だから先生がみんなで遊べるからって言ったの	だから先生がみんなで遊べるからって言ったの
これだったらいいんだって！	これだったらいいんだって！	これだったらいいんだって！	これだったらいいんだって！
楽しいの？	楽しいの？	楽しいの？	楽しいの？
そんなにたのしくないよ！	そんなにたのしくないよ！	そんなにたのしくないよ！	そんなにたのしくないよ！
でもみんなこれしかやらないから	でもみんなこれしかやらないから	でもみんなこれしかやらないから	でもみんなこれしかやらないから
わたしはおしゃべり禁止だし……	わたしはおしゃべり禁止だし……	わたしはおしゃべり禁止だし……	わたしはおしゃべり禁止だし……
だれもおしゃべりしてくれないから……	だれもおしゃべりしてくれないから……	だれもおしゃべりしてくれないから……	だれもおしゃべりしてくれないから……
むかしね、みんなあかちゃんだったでしょ！	むかしね、みんなあかちゃんだったでしょ！	むかしね、みんなあかちゃんだったでしょ！	むかしね、みんなあかちゃんだったでしょ！
そうなの？	そうなの？	そうなの？	そうなの？
あかちゃんはいいよねー、しゃべったらほめてくれるんだもん！	あかちゃんはいいよねー、しゃべったらほめてくれるんだもん！	あかちゃんはいいよねー、しゃべったらほめてくれるんだもん！	あかちゃんはいいよねー、しゃべったらほめてくれるんだもん！
ねえねえ、空の上には極楽があるって先生はいうんだけどさあ！	ねえねえ、空の上には極楽があるって先生はいうんだけどさあ！	ねえねえ、空の上には極楽があるって先生はいうんだけどさあ！	ねえねえ、空の上には極楽があるって先生はいうんだけどさあ！
うん	うん	うん	うん
ぜったいうそだよねー！	ぜったいうそだよねー！	ぜったいうそだよねー！	ぜったいうそだよねー！
だってみえないんだもん	だってみえないんだもん	だってみえないんだもん	だってみえないんだもん
お空に飛べたらぶつかっちゃうしね	お空に飛べたらぶつかっちゃうしね	お空に飛べたらぶつかっちゃうしね	お空に飛べたらぶつかっちゃうしね
うわ！	うわ！	うわ！	うわ！
これ飛ぶ奴だよね！	これ飛ぶ奴だよね！	これ飛ぶ奴だよね！	これ飛ぶ奴だよね！
わーっ......	わーっ......	わーっ......	わーっ......
これどこまで飛ぶかなあ	これどこまで飛ぶかなあ	これどこまで飛ぶかなあ	これどこまで飛ぶかなあ
やってみようよ！	やってみようよ！	やってみようよ！	やってみようよ！
何	何	何	何
えっ？	えっ？	えっ？	えっ？
なんだよ	なんだよ	なんだよ	なんだよ
用がないならあっちいけよ	用がないならあっちいけよ	用がないならあっちいけよ	用がないならあっちいけよ
あそばないの？	あそばないの？	あそばないの？	あそばないの？
は？	は？	は？	は？
もう遊んでるだろ	もう遊んでるだろ	もう遊んでるだろ	もう遊んでるだろ
............	............	............	............
なんだよ！あっちいけよ！	なんだよ！あっちいけよ！	なんだよ！あっちいけよ！	なんだよ！あっちいけよ！
…………	…………	…………	…………
う............	う............	う............	う............
みんなわたしのこときらいだって	みんなわたしのこときらいだって	みんなわたしのこときらいだって	みんなわたしのこときらいだって
うらやましい......	うらやましい......	うらやましい......	うらやましい......
みんなみたいになりたい	みんなみたいになりたい	みんなみたいになりたい	みんなみたいになりたい
じぶんがきらい！	じぶんがきらい！	じぶんがきらい！	じぶんがきらい！
もういや……	もういや……	もういや……	もういや……
ひみつきちだって……	ひみつきちだって……	ひみつきちだって……	ひみつきちだって……
わたし入れてもらえない	わたし入れてもらえない	わたし入れてもらえない	わたし入れてもらえない
あら	あら	あら	あら
あなたも私が気になるの？	あなたも私が気になるの？	あなたも私が気になるの？	あなたも私が気になるの？
え？	え？	え？	え？
なにが？	なにが？	なにが？	なにが？
わたしがすきなんでしょ？	わたしがすきなんでしょ？	わたしがすきなんでしょ？	わたしがすきなんでしょ？
？	？	？	？
みんな私が大好きなの！	みんな私が大好きなの！	みんな私が大好きなの！	みんな私が大好きなの！
あなたも好きだよね！	あなたも好きだよね！	あなたも好きだよね！	あなたも好きだよね！
ねえ、なんでそんなこと言うの？	ねえ、なんでそんなこと言うの？	ねえ、なんでそんなこと言うの？	ねえ、なんでそんなこと言うの？
なにが？	なにが？	なにが？	なにが？
・・・・・・…………	・・・・・・…………	・・・・・・…………	・・・・・・…………
わたしはゴミじゃない！	わたしはゴミじゃない！	わたしはゴミじゃない！	わたしはゴミじゃない！
私は捨てられていない！	私は捨てられていない！	私は捨てられていない！	私は捨てられていない！
パパもママも好きって言ったもん	パパもママも好きって言ったもん	パパもママも好きって言ったもん	パパもママも好きって言ったもん
ほんとだもん！	ほんとだもん！	ほんとだもん！	ほんとだもん！
迎えに来てくれるもん！	迎えに来てくれるもん！	迎えに来てくれるもん！	迎えに来てくれるもん！
！	！	！	！
みずあそびするの？	みずあそびするの？	みずあそびするの？	みずあそびするの？
わたしそれ得意だから！	わたしそれ得意だから！	わたしそれ得意だから！	わたしそれ得意だから！
みてて！みてて！	みてて！みてて！	みてて！みてて！	みてて！みてて！
げえっ！	げえっ！	げえっ！	げえっ！
い、いつからそこに	い、いつからそこに	い、いつからそこに	い、いつからそこに
........................	........................	........................	........................
わかりました！	わかりました！	わかりました！	わかりました！
わかりましたよ！	わかりましたよ！	わかりましたよ！	わかりましたよ！
いまやるから、もうちょっとまっててくれよ	いまやるから、もうちょっとまっててくれよ	いまやるから、もうちょっとまっててくれよ	いまやるから、もうちょっとまっててくれよ
フーっ、まいったぜ……	フーっ、まいったぜ……	フーっ、まいったぜ……	フーっ、まいったぜ……
何が？	何が？	何が？	何が？
いやこっちの話	いやこっちの話	いやこっちの話	いやこっちの話
とにかく疲れちまったから放っておいてくれ	とにかく疲れちまったから放っておいてくれ	とにかく疲れちまったから放っておいてくれ	とにかく疲れちまったから放っておいてくれ
お仕事しなきゃなあ	お仕事しなきゃなあ	お仕事しなきゃなあ	お仕事しなきゃなあ
でもしたくないなあ	でもしたくないなあ	でもしたくないなあ	でもしたくないなあ
別に怒られないしあとでいっか......	別に怒られないしあとでいっか......	別に怒られないしあとでいっか......	別に怒られないしあとでいっか......
うう、なんとかなった......	うう、なんとかなった......	うう、なんとかなった......	うう、なんとかなった......
今度はもっと計画的にやろう	今度はもっと計画的にやろう	今度はもっと計画的にやろう	今度はもっと計画的にやろう
こら！	こら！	こら！	こら！
排水溝が詰まってるのにだめでしょ！	排水溝が詰まってるのにだめでしょ！	排水溝が詰まってるのにだめでしょ！	排水溝が詰まってるのにだめでしょ！
あふれちゃって……	あふれちゃって……	あふれちゃって……	あふれちゃって……
みんなおぼれちゃうでしょ！	みんなおぼれちゃうでしょ！	みんなおぼれちゃうでしょ！	みんなおぼれちゃうでしょ！
ちゃんと掃除して頂戴！	ちゃんと掃除して頂戴！	ちゃんと掃除して頂戴！	ちゃんと掃除して頂戴！
オッ熊手が欲しいのかい！	オッ熊手が欲しいのかい！	オッ熊手が欲しいのかい！	オッ熊手が欲しいのかい！
それなら、えー	それなら、えー	それなら、えー	それなら、えー
500だ！	500だ！	500だ！	500だ！
500って、お金のこと？	500って、お金のこと？	500って、お金のこと？	500って、お金のこと？
こんな小娘、100も持ってないだろう	こんな小娘、100も持ってないだろう	こんな小娘、100も持ってないだろう	こんな小娘、100も持ってないだろう
でも取れるところから取っておかないとな	でも取れるところから取っておかないとな	でも取れるところから取っておかないとな	でも取れるところから取っておかないとな
さ、お財布見せてごらん！	さ、お財布見せてごらん！	さ、お財布見せてごらん！	さ、お財布見せてごらん！
お財布もってないの	お財布もってないの	お財布もってないの	お財布もってないの
でも水道さんが困ってるから......	でも水道さんが困ってるから......	でも水道さんが困ってるから......	でも水道さんが困ってるから......
あっ！	あっ！	あっ！	あっ！
お前！	お前！	お前！	お前！
待て！	待て！	待て！	待て！
あっ	あっ	あっ	あっ
掃除してくださったのね！	掃除してくださったのね！	掃除してくださったのね！	掃除してくださったのね！
お道具も取りに行ってくださったのね！	お道具も取りに行ってくださったのね！	お道具も取りに行ってくださったのね！	お道具も取りに行ってくださったのね！
えっとね	えっとね	えっとね	えっとね
これね	これね	これね	これね
貸してくれたの	貸してくれたの	貸してくれたの	貸してくれたの
お姉さんが貸してくれたの！	お姉さんが貸してくれたの！	お姉さんが貸してくれたの！	お姉さんが貸してくれたの！
ごめん、いまはあげられるものないんだよね	ごめん、いまはあげられるものないんだよね	ごめん、いまはあげられるものないんだよね	ごめん、いまはあげられるものないんだよね
お金があるなら別だけど	お金があるなら別だけど	お金があるなら別だけど	お金があるなら別だけど
私が話しても誰も返事しない	私が話しても誰も返事しない	私が話しても誰も返事しない	私が話しても誰も返事しない
…………	…………	…………	…………
…………	…………	…………	…………
…………	…………	…………	…………
…………	…………	…………	…………
だから黙ってなきゃ	だから黙ってなきゃ	だから黙ってなきゃ	だから黙ってなきゃ
…………	…………	…………	…………
…………	…………	…………	…………
…………	…………	…………	…………
…………	…………	…………	…………
どうしたの？	どうしたの？	どうしたの？	どうしたの？
ああ、あの子？	ああ、あの子？	ああ、あの子？	ああ、あの子？
あのこちょっと怖いから……	あのこちょっと怖いから……	あのこちょっと怖いから……	あのこちょっと怖いから……
だっていっつも怒ってるんだモン	だっていっつも怒ってるんだモン	だっていっつも怒ってるんだモン	だっていっつも怒ってるんだモン
みんなで遊ぶのはいいけど、あの子と一緒にいるの嫌なの	みんなで遊ぶのはいいけど、あの子と一緒にいるの嫌なの	みんなで遊ぶのはいいけど、あの子と一緒にいるの嫌なの	みんなで遊ぶのはいいけど、あの子と一緒にいるの嫌なの
ひつみきちってなんなの？	ひつみきちってなんなの？	ひつみきちってなんなの？	ひつみきちってなんなの？
秘密基地？	秘密基地？	秘密基地？	秘密基地？
友達だけが入れる秘密の部屋があるの！	友達だけが入れる秘密の部屋があるの！	友達だけが入れる秘密の部屋があるの！	友達だけが入れる秘密の部屋があるの！
うーん教えようかな、どうしようかな	うーん教えようかな、どうしようかな	うーん教えようかな、どうしようかな	うーん教えようかな、どうしようかな
こわいけどやさしいもの、なーんだ？	こわいけどやさしいもの、なーんだ？	こわいけどやさしいもの、なーんだ？	こわいけどやさしいもの、なーんだ？
え？	え？	え？	え？
わたしあの子のことあんまり知らない	わたしあの子のことあんまり知らない	わたしあの子のことあんまり知らない	わたしあの子のことあんまり知らない
だっていっつも怒ってるから	だっていっつも怒ってるから	だっていっつも怒ってるから	だっていっつも怒ってるから
ひつみきちってしってる？	ひつみきちってしってる？	ひつみきちってしってる？	ひつみきちってしってる？
知ってるよ！	知ってるよ！	知ってるよ！	知ってるよ！
あのね！	あのね！	あのね！	あのね！
あーでもこれ秘密だった	あーでもこれ秘密だった	あーでもこれ秘密だった	あーでもこれ秘密だった
秘密基地だから……	秘密基地だから……	秘密基地だから……	秘密基地だから……
だいきらいなのに離れたくないもの、なーんだ？	だいきらいなのに離れたくないもの、なーんだ？	だいきらいなのに離れたくないもの、なーんだ？	だいきらいなのに離れたくないもの、なーんだ？
ぷーーーー	ぷーーーー	ぷーーーー	ぷーーーー
ぷーっぷーっぷーっ	ぷーっぷーっぷーっ	ぷーっぷーっぷーっ	ぷーっぷーっぷーっ
泣いてる子だあれ？	泣いてる子だあれ？泣いてる子は迎えに行くよ	泣いてる子だあれ？泣いてる子は迎えに行くよ	泣いてる子だあれ？泣いてる子は迎えに行くよ
らりるれろ！らりるれろ！	らりるれろ！らりるれろ！らりるれろ！	らりるれろ！らりるれろ！らりるれろ！	らりるれろ！らりるれろ！らりるれろ！
そこで見てるのだれ？	そこで見てるのだれ？	そこで見てるのだれ？	そこで見てるのだれ？
もしもし、どなた？	もしもし、どなた？	もしもし、どなた？	もしもし、どなた？
もしもし？	もしもし？	もしもし？	もしもし？
あなたなの？	あなたなの？	あなたなの？	あなたなの？
はい わたしです	はい わたしです	はい わたしです	はい わたしです
はい	はい	はい	はい
問題なく	問題なく	問題なく	問題なく
はい	はい	はい	はい
すべてをやり直せます	すべてをやり直せます	すべてをやり直せます	すべてをやり直せます
彼女はいまも眠っています	彼女はいまも眠っています	彼女はいまも眠っています	彼女はいまも眠っています
心的外傷を癒す時が来たのです	心的外傷を癒す時が来たのです	心的外傷を癒す時が来たのです	心的外傷を癒す時が来たのです
彼女こそあなたの”ソフィー”です	彼女こそあなたの”ソフィー”です	彼女こそあなたの”ソフィー”です	彼女こそあなたの”ソフィー”です
もしもし？	もしもし？	もしもし？	もしもし？
迷惑なんですけど！	迷惑なんですけど！	迷惑なんですけど！	迷惑なんですけど！
ひょっとしてメリーさん？	ひょっとしてメリーさん？	ひょっとしてメリーさん？	ひょっとしてメリーさん？
やめなさいよ！	やめなさいよ！	やめなさいよ！	やめなさいよ！
もうかけてこないで！	もうかけてこないで！	もうかけてこないで！	もうかけてこないで！
ごめんなさい！	ごめんなさい！	ごめんなさい！	ごめんなさい！
おねがいします！	おねがいします！	おねがいします！	おねがいします！
おかけになった電話番号はーー	おかけになった電話番号は現在使われておりません。	おかけになった電話番号は現在使われておりません。	おかけになった電話番号は現在使われておりません。
天気予告をお知らせいたします。	天気予告をお知らせいたします。	天気予告をお知らせいたします。	天気予告をお知らせいたします。
明日の天気はハレ、明日の天気はハレ	明日の天気はハレ、明日の天気はハレ	明日の天気はハレ、明日の天気はハレ	明日の天気はハレ、明日の天気はハレ
こんにちは	こんにちは	こんにちは	こんにちは
おでんわありがとう！	おでんわありがとう！	おでんわありがとう！	おでんわありがとう！
おはなししましょ！	おはなししましょ！	おはなししましょ！	おはなししましょ！
ばいばーい！	ばいばーい！	ばいばーい！	ばいばーい！
火事ですか救急ですか？	火事ですか救急ですか？	火事ですか救急ですか？	火事ですか救急ですか？
あのね、何でもないです	あのね、何でもないです	あのね、何でもないです	あのね、何でもないです
申します申します、どちらへお繋しますか？	申します申します、どちらへお繋しますか？	申します申します、どちらへお繋しますか？	申します申します、どちらへお繋しますか？
おかあさん	おかあさん	おかあさん	おかあさん
おかあさん	おかあさん	おかあさん	おかあさん
どうして？	どうして？	どうして？	どうして？
あ！	あ！	あ！	あ！
そのお人形！	そのお人形！	そのお人形！	そのお人形！
それ私のよ！	それ私のよ！	それ私のよ！	それ私のよ！
うん	うん	うん	うん
へへっ	へへっ	へへっ	へへっ
これでいい？	これでいい？	これでいい？	これでいい？
うん？	うん？	うん？	うん？
ああ	ああ	ああ	ああ
うん	うん	うん	うん
おーい！	おーい！	おーい！	おーい！
ふん！	ふん！	ふん！	ふん！
この楽しさがわからないなんて	この楽しさがわからないなんて	この楽しさがわからないなんて	この楽しさがわからないなんて
なんて馬鹿なのかしら	なんて馬鹿なのかしら	なんて馬鹿なのかしら	なんて馬鹿なのかしら
なんなの？	なんなの？	なんなの？	なんなの？
あっちいってよ！	あっちいってよ！	あっちいってよ！	あっちいってよ！
こんなとこくるんじゃなかったわ	こんなとこくるんじゃなかったわ	こんなとこくるんじゃなかったわ	こんなとこくるんじゃなかったわ
へんなこ！	へんなこ！	へんなこ！	へんなこ！
合言葉は？	合言葉は？	合言葉は？	合言葉は？
知らない	知らない	知らない	知らない
合言葉は？	合言葉は？	合言葉は？	合言葉は？
先生/お母さん/友達/兄弟	先生/お母さん/友達/兄弟	先生/お母さん/友達/兄弟	先生/お母さん/友達/兄弟
へえ、気が合うな......	へえ、気が合うな......	へえ、気が合うな......	へえ、気が合うな......
中のものが欲しいのか？	中のものが欲しいのか？	中のものが欲しいのか？	中のものが欲しいのか？
うん	うん	うん	うん
そら、あの子の忘れ物だ	そら、あの子の忘れ物だ	そら、あの子の忘れ物だ	そら、あの子の忘れ物だ
じゃあな	じゃあな	じゃあな	じゃあな
あれ？	あれ？	あれ？	あれ？
水でないなー	水でないなー	水でないなー	水でないなー
熊手ある？	熊手ある？	熊手ある？	熊手ある？
オッ熊手が欲しいのかい！	オッ熊手が欲しいのかい！	オッ熊手が欲しいのかい！	オッ熊手が欲しいのかい！
それなら、えー	それなら、えー	それなら、えー	それなら、えー
500だ！	500だ！	500だ！	500だ！
500って、お金のこと？	500って、お金のこと？	500って、お金のこと？	500って、お金のこと？
さ、お財布見せてごらん！	さ、お財布見せてごらん！	さ、お財布見せてごらん！	さ、お財布見せてごらん！
お財布もってないの	お財布もってないの	お財布もってないの	お財布もってないの
でも水道さんが困ってるから......	でも水道さんが困ってるから......	でも水道さんが困ってるから......	でも水道さんが困ってるから......
......	......	......	......
わかった、貸すだけだぞ！	わかった、貸すだけだぞ！	わかった、貸すだけだぞ！	わかった、貸すだけだぞ！
熊手は役に立ったかい？	熊手は役に立ったかい？	熊手は役に立ったかい？	熊手は役に立ったかい？
今度はちゃんとお金をもらってくるんだぞ！	今度はちゃんとお金をもらってくるんだぞ！	今度はちゃんとお金をもらってくるんだぞ！	今度はちゃんとお金をもらってくるんだぞ！
仮面屋よりも、もっとやりたいことあるんだよね	仮面屋よりも、もっとやりたいことあるんだよね	仮面屋よりも、もっとやりたいことあるんだよね	仮面屋よりも、もっとやりたいことあるんだよね
あなたはどう？	あなたはどう？	あなたはどう？	あなたはどう？
本当はやってみたいこと、ない？	本当はやってみたいこと、ない？	本当はやってみたいこと、ない？	本当はやってみたいこと、ない？
合言葉は仲間にしか教えちゃいけないんだぜ	合言葉は仲間にしか教えちゃいけないんだぜ	合言葉は仲間にしか教えちゃいけないんだぜ	合言葉は仲間にしか教えちゃいけないんだぜ
秘密だからな	秘密だからな	秘密だからな	秘密だからな
おいで	おいで	おいで	おいで
あなたはいい子にならなきゃだめよ	あなたはいい子にならなきゃだめよ	あなたはいい子にならなきゃだめよ	あなたはいい子にならなきゃだめよ
変なの	変なの	変なの	変なの
ねえ、にんぎょうごっこしましょ！	ねえ、にんぎょうごっこしましょ！	ねえ、にんぎょうごっこしましょ！	ねえ、にんぎょうごっこしましょ！
なにそれえ	なにそれえ	なにそれえ	なにそれえ
見てて	見てて	見てて	見てて
そんなのつまんないじゃん	そんなのつまんないじゃん	そんなのつまんないじゃん	そんなのつまんないじゃん
ねえ、人形ごっこしましょ！	ねえ、人形ごっこしましょ！	ねえ、人形ごっこしましょ！	ねえ、人形ごっこしましょ！
お気に入りの子供をかわいがるの	お気に入りの子供をかわいがるの	お気に入りの子供をかわいがるの	お気に入りの子供をかわいがるの
やぁよ	やぁよ	やぁよ	やぁよ
私たちいまから縄跳びで遊ぶの	私たちいまから縄跳びで遊ぶの	私たちいまから縄跳びで遊ぶの	私たちいまから縄跳びで遊ぶの
それより人形遊びのほうが賢いし素敵よ	それより人形遊びのほうが賢いし素敵よ	それより人形遊びのほうが賢いし素敵よ	それより人形遊びのほうが賢いし素敵よ
なわとびなんて汚くなるし人生を無駄にしてる	なわとびなんて汚くなるし人生を無駄にしてる	なわとびなんて汚くなるし人生を無駄にしてる	なわとびなんて汚くなるし人生を無駄にしてる
頭おかしいのね！	頭おかしいのね！	頭おかしいのね！	頭おかしいのね！
なんでそんなこと言われなきゃならないの？	なんでそんなこと言われなきゃならないの？	なんでそんなこと言われなきゃならないの？	なんでそんなこと言われなきゃならないの？
バカにしに来たわけ？	バカにしに来たわけ？	バカにしに来たわけ？	バカにしに来たわけ？
もういい	もういい	もういい	もういい
あっ	あっ	あっ	あっ
あいてのきもちになる	あいてのきもちになる	あいてのきもちになる	あいてのきもちになる
もうおうちにかえる	もうおうちにかえる	もうおうちにかえる	もうおうちにかえる
まだねむたくないもん	まだねむたくないもん	まだねむたくないもん	まだねむたくないもん
にっきさんひさしぶり！またね！	にっきさんひさしぶり！またね！	にっきさんひさしぶり！またね！	にっきさんひさしぶり！またね！
くれおん！/もうピンクない	くれおん！/もうピンクない	くれおん！/もうピンクない	くれおん！/もうピンクない
なにかいる！	なにかいる！	なにかいる！	なにかいる！
あけない	あけない	あけない	あけない
ここジョンのばしょ！/いいこいいこ！/ばいばい	ここジョンのばしょ！/いいこいいこ！/ばいばい	ここジョンのばしょ！/いいこいいこ！/ばいばい	ここジョンのばしょ！/いいこいいこ！/ばいばい
みずさしー	みずさしー	みずさしー	みずさしー
これはかびん……おおきいから	これはかびん……おおきいから	これはかびん……おおきいから	これはかびん……おおきいから
かびん！	かびん！	かびん！	かびん！
さっきのこいないなー	さっきのこいないなー	さっきのこいないなー	さっきのこいないなー
このはっぱ、えがかけるよ	このはっぱ、えがかけるよ	このはっぱ、えがかけるよ	このはっぱ、えがかけるよ
まぶしい	まぶしい	まぶしい	まぶしい
これうるさいからきらい	これうるさいからきらい	これうるさいからきらい	これうるさいからきらい
あとでのろっと	あとでのろっと	あとでのろっと	あとでのろっと
だれかとって！	だれかとって！	だれかとって！	だれかとって！
いまはかくれんぼしてないからあとでね！	いまはかくれんぼしてないからあとでね！	いまはかくれんぼしてないからあとでね！	いまはかくれんぼしてないからあとでね！
あしおれたらのってもいい？	あしおれたらのってもいい？	あしおれたらのってもいい？	あしおれたらのってもいい？
へんなベッド	へんなベッド	へんなベッド	へんなベッド
くすりはいらない……	くすりはいらない……	くすりはいらない……	くすりはいらない……
くーくーばこ！けがしてないよ！	くーくーばこ！けがしてないよ！	くーくーばこ！けがしてないよ！	くーくーばこ！けがしてないよ！
やだやだ。	やだやだ。	やだやだ。	やだやだ。
ばんこーそー？	ばんこーそー？	ばんこーそー？	ばんこーそー？
ナイフ	ナイフ	ナイフ	ナイフ
くすぐったーい！	くすぐったーい！	くすぐったーい！	くすぐったーい！
だれかじゅんびちゅう？	だれかじゅんびちゅう？	だれかじゅんびちゅう？	だれかじゅんびちゅう？
こーえん？	こーえん？	こーえん？	こーえん？
いってもいいかな	いってもいいかな	いってもいいかな	いってもいいかな
まっていればいいのかな	まっていればいいのかな	まっていればいいのかな	まっていればいいのかな
まだかなー	まだかなー	まだかなー	まだかなー
こない	こない	こない	こない
からっぽ！	からっぽ！	からっぽ！	からっぽ！
わかんない	わかんない	わかんない	わかんない
くすぐったいやつ	くすぐったいやつ	くすぐったいやつ	くすぐったいやつ
これさわるといろがかわるんだよ！	これさわるといろがかわるんだよ！	これさわるといろがかわるんだよ！	これさわるといろがかわるんだよ！
おつきさまとれるかな	おつきさまとれるかな	おつきさまとれるかな	おつきさまとれるかな
みっけ！	みっけ！	みっけ！	みっけ！
がさがさ！	がさがさ！	がさがさ！	がさがさ！
ざわざわ！	ざわざわ！	ざわざわ！	ざわざわ！
あれ	うーん	うーん	うーん
またへんなかんじ	どうしちゃったんだろう	どうしちゃったんだろう	どうしちゃったんだろう
さむい！	さむい！	さむい！	さむい！
置いて行かれたわ	置いてきぼりね	置いてきぼりね	置いてきぼりね
雪！	雪！	雪！	雪！
つめたーい	寒いはずだわ	寒いはずだわ	寒いはずだわ
わあー	わあー	わあー	わあー
真っ白ね	すごい雪	すごい雪	すごい雪
あら	あら	あら	あら
出られないの？	何をしてるのかしら	何をしてるのかしら	何をしてるのかしら
助けてあげるね	助けなきゃ	助けなきゃ	助けなきゃ
よいしょ	よいしょ	よいしょ	よいしょ
うん	うん	うん	うん
ぐえ	ぐえ	ぐえ	ぐえ
えい	えい	えい	えい
ぐえ	ぐえ	ぐえ	ぐえ
えい	えい	えい	えい
ぐええっ	ぐええっ	ぐええっ	ぐええっ
やった！	やった！	やった！	やった！
うげっ	うげっ	うげっ	うげっ
この木さむそう！	葉っぱはどこ行っちゃったの	葉っぱはどこ行っちゃったの	葉っぱはどこ行っちゃったの
おまえー！	おまえー！	おまえー！	おまえー！
せっかくいいところだったのに！	せっかくいいところだったのに！	せっかくいいところだったのに！	せっかくいいところだったのに！
でも死んじゃうわ	でも凍え死ぬわ	でも凍え死ぬわ	でも凍え死ぬわ
あたいはね、	あたいはね、	あたいはね、	あたいはね、
だるまになりたいの！	だるまになりたいの！	だるまになりたいの！	だるまになりたいの！
邪魔しないでよ	邪魔しないでよ	邪魔しないでよ	邪魔しないでよ
？	？	？	？
のこぎり使えば？	のこぎり使えば？	のこぎり使えば？	のこぎり使えば？
スノーマンよ！	スノーマンよ！	スノーマンよ！	スノーマンよ！
ふーん	ふーん	ふーん	ふーん
あたいは人気者になりたいの！	あたいは人気者になりたいの！	あたいは人気者になりたいの！	あたいは人気者になりたいの！
責任取って雪だるまにして！	責任取って雪だるまにして！	責任取って雪だるまにして！	責任取って雪だるまにして！
なんで？	なんで雪だるまなの？	なんで雪だるまなの？	なんで雪だるまなの？
雪だるまはねえ！	雪だるまはねえ！	雪だるまはねえ！	雪だるまはねえ！
みんなに抱きしめてもらえるの！	みんなに抱きしめてもらえるの！	みんなに抱きしめてもらえるの！	みんなに抱きしめてもらえるの！
氷の像なんかと違ってね！	氷の像なんかと違ってね！	氷の像なんかと違ってね！	氷の像なんかと違ってね！
だからあたいを雪だるまにして！	だからあたいを雪だるまにして！	だからあたいを雪だるまにして！	だからあたいを雪だるまにして！
いいよ！/いいよ/いいよ......	いいよ！/いいよ/いいよ......	いいよ！/いいよ/いいよ......	いいよ！/いいよ/いいよ......
きまりね	きまりね	きまりね	きまりね
ふつうの雪だるまじゃないのよ！	ふつうの雪だるまじゃないのよ！	ふつうの雪だるまじゃないのよ！	ふつうの雪だるまじゃないのよ！
世界一の雪だるまになるんだから！	世界一の雪だるまになるんだから！	世界一の雪だるまになるんだから！	世界一の雪だるまになるんだから！
あたいならできる！	あたいならできる！	あたいならできる！	あたいならできる！
計画はね！	計画はね！	計画はね！	計画はね！
わたしのからだにいっぱい雪をつけるでしょ	わたしのからだにいっぱい雪をつけるでしょ	わたしのからだにいっぱい雪をつけるでしょ	わたしのからだにいっぱい雪をつけるでしょ
そしたらからだがおっきくなるから	そしたらからだがおっきくなるから	そしたらからだがおっきくなるから	そしたらからだがおっきくなるから
そしたらおっきなゆきだるまになるから	そしたらおっきなゆきだるまになるから	そしたらおっきなゆきだるまになるから	そしたらおっきなゆきだるまになるから
すごいでしょ！	すごいでしょ！	すごいでしょ！	すごいでしょ！
いいわ	いいわ	いいわ	いいわ
やる	やる	やる	やる
これ見て！	これ見て！	これ見て！	これ見て！
完璧な計画よね！	完璧な計画よね！	完璧な計画よね！	完璧な計画よね！
わたしは雪を集めておくから！	わたしは雪を集めておくから！	わたしは雪を集めておくから！	わたしは雪を集めておくから！
冷たくないの？	冷たくないの？	冷たくないの？	冷たくないの？
なにがー？	なにがー？	なにがー？	なにがー？
手が	手が	手が	手が
つめたくないよ！	つめたくないよ！	つめたくないよ！	つめたくないよ！
ゆきんこだからへいきなの！	ゆきんこだからへいきなの！	ゆきんこだからへいきなの！	ゆきんこだからへいきなの！
ゆきんこだからゆきだるまも一番になるから！	ゆきんこだからゆきだるまも一番になるから！	ゆきんこだからゆきだるまも一番になるから！	ゆきんこだからゆきだるまも一番になるから！
あなたもじゅんびしてよ！	あなたもじゅんびしてよ！	あなたもじゅんびしてよ！	あなたもじゅんびしてよ！
材料用意して！	材料用意して！	材料用意して！	材料用意して！
ねえあなたお友達いる？	ねえあなたお友達いる？	ねえあなたお友達いる？	ねえあなたお友達いる？
いないよ！	いないよ！	いないよ！	いないよ！
わたしに釣り合う奴なんていないから！	わたしに釣り合う奴なんていないから！	わたしに釣り合う奴なんていないから！	わたしに釣り合う奴なんていないから！
大きいなあ	立派！	立派！	立派！
誰のお墓なんだろう？	誰のお墓かしら	誰のお墓かしら	誰のお墓かしら
うわー	うわー	うわー	うわー
なんかへんなの	誰だろう？	誰だろう？	誰だろう？
わるもの？	なんでしんだの？	なんでしんだの？	なんでしんだの？
まっしろだわ！	まっしろだわ！	まっしろだわ！	まっしろだわ！
これスノーマンかしら	これスノーマンかしら	これスノーマンかしら	これスノーマンかしら
責任についてどう思っているんだ	責任についてどう思っているんだ	責任についてどう思っているんだ	責任についてどう思っているんだ
なにが	なんのこと	なんのこと	なんのこと
約束や責任を何だと思っているんだ！	約束や責任を何だと思っているんだ！	約束や責任を何だと思っているんだ！	約束や責任を何だと思っているんだ！
しらなーい	どうでもいいわ	どうでもいいわ	どうでもいいわ
女の子が引っかかってる！	女の子が引っかかってる！	女の子が引っかかってる！	女の子が引っかかってる！
助けなきゃ	助けなきゃ	助けなきゃ	助けなきゃ
よいしょ	よいしょ	よいしょ	よいしょ
よいしょ	よいしょ	よいしょ	よいしょ
うーん	うーん	うーん	うーん
ううーん	ううーん	ううーん	ううーん
この木もはだかんぼ！	この木も恥ずかしそう	この木も恥ずかしそう	この木も恥ずかしそう
わあーっ	まあ！	まあ！	まあ！
なんてきれいなの	奇麗だわ	奇麗だわ	奇麗だわ
あらお嬢様のご友人様かしら	あらお嬢様のご友人様かしら	あらお嬢様のご友人様かしら	あらお嬢様のご友人様かしら
友達？	誰の事	誰の事	誰の事
思い過ごしかしら？	思い過ごしかしら？	思い過ごしかしら？	思い過ごしかしら？
彼女と貴方はとても似ているわ	彼女と貴方はとても似ているわ	彼女と貴方はとても似ているわ	彼女と貴方はとても似ているわ
きっと彼女と貴方で”いい仕事”ができるわよ	きっと彼女と貴方で”いい仕事”ができるわよ	きっと彼女と貴方で”いい仕事”ができるわよ	きっと彼女と貴方で”いい仕事”ができるわよ
また悪ガキね	また悪ガキね	また悪ガキね	また悪ガキね
私の仕事場を荒らさないで頂戴	私の仕事場を荒らさないで頂戴	私の仕事場を荒らさないで頂戴	私の仕事場を荒らさないで頂戴
仕事場？	仕事場？	仕事場？	仕事場？
子どもは外で遊ぶものよ	子どもは外で遊ぶものよ	子どもは外で遊ぶものよ	子どもは外で遊ぶものよ
出て行ってちょうだい！	出て行ってちょうだい！	出て行ってちょうだい！	出て行ってちょうだい！
おやおや	おやおや	おやおや	おやおや
可愛らしいお客様ですね	可愛らしいお客様ですね	可愛らしいお客様ですね	可愛らしいお客様ですね
何の御用ですか？	何の御用ですか？	何の御用ですか？	何の御用ですか？
ええーっと	ええーっと	ええーっと	ええーっと
なんだろう	なんだろう	なんだろう	なんだろう
あら！	あら！	あら！	あら！
こんにちは	こんにちは	こんにちは	こんにちは
あー	あー	あー	あー
こんにちは	こんにちは	こんにちは	こんにちは
奇麗でしょう！	奇麗でしょう！	奇麗でしょう！	奇麗でしょう！
ぜんぶ作ったのよ！	ぜんぶ作ったのよ！	ぜんぶ作ったのよ！	ぜんぶ作ったのよ！
雪だるまもぜーんぶ	雪だるまもぜーんぶ	雪だるまもぜーんぶ	雪だるまもぜーんぶ
すごいでしょ	すごいでしょ	すごいでしょ	すごいでしょ
そうね	そうね	そうね	そうね
おねえちゃんが教えてくれたんだ	おねえちゃんが教えてくれたんだ	おねえちゃんが教えてくれたんだ	おねえちゃんが教えてくれたんだ
あなた家族は	あなた家族は	あなた家族は	あなた家族は
............	............	............	............
私も雪だるま作るの	私も雪だるま作るの	私も雪だるま作るの	私も雪だるま作るの
............	............	............	............
そうなんだ	そうなんだ	そうなんだ	そうなんだ
じゃあこれ貸してあげる	じゃあこれ貸してあげる	じゃあこれ貸してあげる	じゃあこれ貸してあげる
ありがとう！	ありがとう！	ありがとう！	ありがとう！
ゆきだるまいっしょにやる？	ゆきだるまいっしょにやる？	ゆきだるまいっしょにやる？	ゆきだるまいっしょにやる？
やる！	やる！	やる！	やる！
わたし、ものづくりの達人なのよ！	わたし、ものづくりの達人なのよ！	わたし、ものづくりの達人なのよ！	わたし、ものづくりの達人なのよ！
はやく作りましょ！	はやく作りましょ！	はやく作りましょ！	はやく作りましょ！
どこで作る？	どこで作る？	どこで作る？	どこで作る？
こっちよ	あっちにもう一人友達いるの	あっちにもう一人友達いるの	あっちにもう一人友達いるの
はやくいきましょ！	わかったわ	わかったわ	わかったわ
おっきいなー	おっきいなー	おっきいなー	おっきいなー
えへへ	えへへ	えへへ	えへへ
これなに？	これなに？	これなに？	これなに？
冬飾りよ	冬飾りよ	冬飾りよ	冬飾りよ
毎年雪が積もったら木をきれいにするの	毎年雪が積もったら木をきれいにするの	毎年雪が積もったら木をきれいにするの	毎年雪が積もったら木をきれいにするの
なんで？	なんで？	なんで？	なんで？
そのほうが楽しいから！	そのほうが楽しいから！	そのほうが楽しいから！	そのほうが楽しいから！
いっぱい雪が降ったらやることなくなっちゃうからね！	いっぱい雪が降ったらやることなくなっちゃうからね！	いっぱい雪が降ったらやることなくなっちゃうからね！	いっぱい雪が降ったらやることなくなっちゃうからね！
それはだめよ！	それはだめよ！	それはだめよ！	それはだめよ！
それはわたしの	それはわたしの	それはわたしの	それはわたしの
わかった	ごめんなさい	ごめんなさい	ごめんなさい
あ！	あ！	あ！	あ！
ちょっと！	ちょっと！	ちょっと！	ちょっと！
なんでこの子を連れてきたの	なんでこの子を連れてきたの	なんでこの子を連れてきたの	なんでこの子を連れてきたの
あー	あー	あー	あー
なるほどね	なるほどね	なるほどね	なるほどね
あなたがいたのね	あなたがいたのね	あなたがいたのね	あなたがいたのね
そりゃうまくいかないでしょうね	そりゃうまくいかないでしょうね	そりゃうまくいかないでしょうね	そりゃうまくいかないでしょうね
なんですって！	なんですって！	なんですって！	なんですって！
何でもかんでも壊すくせに	何でもかんでも壊すくせに	何でもかんでも壊すくせに	何でもかんでも壊すくせに
そんなあんたがゲージュツをリカイできるの？	そんなあんたがゲージュツをリカイできるの？	そんなあんたがゲージュツをリカイできるの？	そんなあんたがゲージュツをリカイできるの？
ふん！	ふん！	ふん！	ふん！
おねーちゃんがいったもん！	おねーちゃんがいったもん！	おねーちゃんがいったもん！	おねーちゃんがいったもん！
自分で作ったものは壊していいし	自分で作ったものは壊していいし	自分で作ったものは壊していいし	自分で作ったものは壊していいし
壊したぶんまたつくればいいのよ！	壊したぶんまたつくればいいのよ！	壊したぶんまたつくればいいのよ！	壊したぶんまたつくればいいのよ！
そんなことも知らないの？	そんなことも知らないの？	そんなことも知らないの？	そんなことも知らないの？
ばかじゃない？	ばかじゃない？	ばかじゃない？	ばかじゃない？
そうやってわたしにケガさせたじゃない！	そうやってわたしにケガさせたじゃない！	そうやってわたしにケガさせたじゃない！	そうやってわたしにケガさせたじゃない！
わたしはヒガイシャなのよ！	わたしはヒガイシャなのよ！	わたしはヒガイシャなのよ！	わたしはヒガイシャなのよ！
セキニンとれ！	セキニンとれ！	セキニンとれ！	セキニンとれ！
わたしの作品に勝手にさわったし	わたしの作品に勝手にさわったし	わたしの作品に勝手にさわったし	わたしの作品に勝手にさわったし
それにバカにした	それにバカにした	それにバカにした	それにバカにした
あなたが悪いのよ	あなたが悪いのよ	あなたが悪いのよ	あなたが悪いのよ
ふん、どうだっていいわ	ふん、どうだっていいわ	ふん、どうだっていいわ	ふん、どうだっていいわ
わたしはこの子と作るから！	わたしはこの子と作るから！	わたしはこの子と作るから！	わたしはこの子と作るから！
ふん、勝手にしたら	ふん、勝手にしたら	ふん、勝手にしたら	ふん、勝手にしたら
ねえ、私とやりたくなったらすぐおいでね	ねえ、私とやりたくなったらすぐおいでね	ねえ、私とやりたくなったらすぐおいでね	ねえ、私とやりたくなったらすぐおいでね
うふふ	うふふ	うふふ	うふふ
やなやつ！	やなやつ！	やなやつ！	やなやつ！
みんなでがんばる/ひとりでがんばる	みんなでがんばる/ひとりでがんばる	みんなでがんばる/ひとりでがんばる	みんなでがんばる/ひとりでがんばる
じゃあまた材料集めてきてね！	じゃあまた材料集めてきてね！	じゃあまた材料集めてきてね！	じゃあまた材料集めてきてね！
うん	うん	うん	うん
うわーっ	うわーっ	うわーっ	うわーっ
だめだこりゃ	だめだこりゃ	だめだこりゃ	だめだこりゃ
材料集めてきたよ	材料集めてきたよ	材料集めてきたよ	材料集めてきたよ
ほんと！	ほんと！	ほんと！	ほんと！
ぜんぜん足りないじゃない！	ぜんぜん足りないじゃない！	ぜんぜん足りないじゃない！	ぜんぜん足りないじゃない！
ちゃんとぜんぶ集めてきてよね！	ちゃんとぜんぶ集めてきてよね！	ちゃんとぜんぶ集めてきてよね！	ちゃんとぜんぶ集めてきてよね！
うん............	うん............	うん............	うん............
おまたせ	おまたせ	おまたせ	おまたせ
ええ！	ええ！	ええ！	ええ！
全然足りないじゃない！	全然足りないじゃない！	全然足りないじゃない！	全然足りないじゃない！
ボタンが足りない！	ボタンが足りない！	ボタンが足りない！	ボタンが足りない！
見つからない	見つからない	見つからない	見つからない
ごめんなさい	しかたないでしょ	しかたないでしょ	しかたないでしょ
やだ！	やだ！	やだ！	やだ！
やだ！やだ！	やだ！やだ！	やだ！やだ！	やだ！やだ！
ちゃんととってこれないんだったら	ちゃんととってこれないんだったら	ちゃんととってこれないんだったら	ちゃんととってこれないんだったら
わたし帰るから！	わたし帰るから！	わたし帰るから！	わたし帰るから！
ごめん	ごめん	ごめん	ごめん
............	............	............	............
じゃあまた材料集めてきてね	じゃあまた材料集めてきてね	じゃあまた材料集めてきてね	じゃあまた材料集めてきてね
わかった	わかった	わかった	わかった
また作ってる	また作ってる	また作ってる	また作ってる
うん	うん	うん	うん
なんで	なんで作るの	なんで作るの	なんで作るの
つくるの、楽しいから	つくるの、楽しいから	つくるの、楽しいから	つくるの、楽しいから
私上手だし！	私上手だし！	私上手だし！	私上手だし！
達人なんだ！	達人なんだ！	達人なんだ！	達人なんだ！
えへへ	えへへ	えへへ	えへへ
うん	ねえ	ねえ	ねえ
なんでそんなに上手なの	なんでそんなに上手なの	なんでそんなに上手なの	なんでそんなに上手なの
おねえちゃんに習ったから	おねえちゃんに習ったから	おねえちゃんに習ったから	おねえちゃんに習ったから
あなたは？	あなたは？	あなたは？	あなたは？
誰に習った？	誰に習った？	誰に習った？	誰に習った？
パパ？	パパ？	パパ？	パパ？
ママ？	ママ？	ママ？	ママ？
おねえちゃん？	おねえちゃん？	おねえちゃん？	おねえちゃん？
............	............	............	............
あのね	あのね	あのね	あのね
なあに	なあに	なあに	なあに
本当はわからないの	本当はわからないの	本当はわからないの	本当はわからないの
............	............	............	............
あのこも	たぶんあの子も同じ	たぶんあの子も同じ	たぶんあの子も同じ
うん	うん	うん	うん
手伝ってちょうだい	いっしょにすごいのを作ってほしいの	いっしょにすごいのを作ってほしいの	いっしょにすごいのを作ってほしいの
すごいのつくろう	すごいので見返したいでしょ	すごいので見返したいでしょ	すごいので見返したいでしょ
ふーん	ふーん	ふーん	ふーん
いいわね	いいわね	いいわね	いいわね
じゃあ丘の上でね	じゃあ丘の上でね	じゃあ丘の上でね	じゃあ丘の上でね
ん	ん	ん	ん
わかった	わかった	わかった	わかった
ねえ	ねえ	ねえ	ねえ
............	............	............	............
............	............	............	............
みんなで作ろ	みんなで作ろ	みんなで作ろ	みんなで作ろ
やだ！	やだ！	やだ！	やだ！
あの子嫌いなんだモン	あの子嫌いなんだモン	あの子嫌いなんだモン	あの子嫌いなんだモン
いいことおもいついたの	いいことおもいついたの	いいことおもいついたの	いいことおもいついたの
............	............	............	............
ねえ	ねえ	ねえ	ねえ
............	............	............	............
いいことおもいついたの	いいことおもいついたの	いいことおもいついたの	いいことおもいついたの
上よ	上よ	上よ	上よ
上って？	上って？	上って？	上って？
丘のほう	丘のほう	丘のほう	丘のほう
雪いっぱいあるし	雪いっぱいあるし	雪いっぱいあるし	雪いっぱいあるし
とおくまでみえるし	とおくまでみえるし	とおくまでみえるし	とおくまでみえるし
いいでしょ	いいでしょ	いいでしょ	いいでしょ
ん	ん	ん	ん
じゃああとでね	じゃああとでね	じゃああとでね	じゃああとでね
うん	うん	うん	うん
どうしたの？	どうしたの？	どうしたの？	どうしたの？
この下が気になるの？	この下が気になるの？	この下が気になるの？	この下が気になるの？
そうなの	そうなの	そうなの	そうなの
じゃあねー	じゃあねー	じゃあねー	じゃあねー
はいこれ！	はいこれ！	はいこれ！	はいこれ！
やっぱりここにあった！	やっぱりここにあった！	やっぱりここにあった！	やっぱりここにあった！
ありがとう！	ありがとう！	ありがとう！	ありがとう！
やっぱりちょっと気持ち悪い	あんまり触りたくない	あんまり触りたくない	あんまり触りたくない
この下が気になるの？	この下が気になるの？	この下が気になるの？	この下が気になるの？
そうなの	そうなの	そうなの	そうなの
じゃあねー	じゃあねー	じゃあねー	じゃあねー
はいこれ！	はいこれ！	はいこれ！	はいこれ！
これがいいアイデアなの？	これがいいアイデアなの？	これがいいアイデアなの？	これがいいアイデアなの？
この子と一緒にやるの？	この子と一緒にやるの？	この子と一緒にやるの？	この子と一緒にやるの？
うん	うん	うん	うん
だって作り方知らないから	だって作り方知らないから	だって作り方知らないから	だって作り方知らないから
わかったわよ！	わかったわよ！	わかったわよ！	わかったわよ！
じゃあほら、とっととやりましょう	じゃあほら、とっととやりましょう	じゃあほら、とっととやりましょう	じゃあほら、とっととやりましょう
でもせかいいちなのよ！せかいいち、作れるの？	でもせかいいちなのよ！せかいいち、作れるの？	でもせかいいちなのよ！せかいいち、作れるの？	でもせかいいちなのよ！せかいいち、作れるの？
もちろんよ	もちろんよ	もちろんよ	もちろんよ
私だって世界一の達人なのよ	私だって世界一の達人なのよ	私だって世界一の達人なのよ	私だって世界一の達人なのよ
おねえちゃんがそう言ったんだから	おねえちゃんがそう言ったんだから	おねえちゃんがそう言ったんだから	おねえちゃんがそう言ったんだから
雪玉を作るときはね、すこしずつゆっくり転がすの	雪玉を作るときはね、すこしずつゆっくり転がすの	雪玉を作るときはね、すこしずつゆっくり転がすの	雪玉を作るときはね、すこしずつゆっくり転がすの
まっすぐじゃなくていろんな向きにね	まっすぐじゃなくていろんな向きにね	まっすぐじゃなくていろんな向きにね	まっすぐじゃなくていろんな向きにね
うん	うん	うん	うん
わかった	うんうん	うんうん	うんうん
これで完璧よ！	これで完璧よ！	これで完璧よ！	これで完璧よ！
わたしは天才だけどやりたか............	わたしは天才だけどやりたか............	わたしは天才だけどやりたか............	わたしは天才だけどやりたか............
やりかたを知らないだけだから	やりかたを知らないだけだから	やりかたを知らないだけだから	やりかたを知らないだけだから
あなたたちは材料をもってきてちょうだい！	あなたたちは材料をもってきてちょうだい！	あなたたちは材料をもってきてちょうだい！	あなたたちは材料をもってきてちょうだい！
まだまだたりないんだから！	まだまだたりないんだから！	まだまだたりないんだから！	まだまだたりないんだから！
雪玉を作るときはね、すこしずつゆっくり転がすの	雪玉を作るときはね、すこしずつゆっくり転がすの	雪玉を作るときはね、すこしずつゆっくり転がすの	雪玉を作るときはね、すこしずつゆっくり転がすの
まっすぐじゃなくていろんな向きにね	まっすぐじゃなくていろんな向きにね	まっすぐじゃなくていろんな向きにね	まっすぐじゃなくていろんな向きにね
うん	うん	うん	うん
わかった	わかった	わかった	わかった
これで完璧よ！	これで完璧よ！	これで完璧よ！	これで完璧よ！
わたしは天才だけどやりたか............	わたしは天才だけどやりたか............	わたしは天才だけどやりたか............	わたしは天才だけどやりたか............
やりかたを知らないだけだから	やりかたを知らないだけだから	やりかたを知らないだけだから	やりかたを知らないだけだから
あなたたちは材料をもってきてちょうだい！	あなたたちは材料をもってきてちょうだい！	あなたたちは材料をもってきてちょうだい！	あなたたちは材料をもってきてちょうだい！
まだまだたりないんだから！	まだまだたりないんだから！	まだまだたりないんだから！	まだまだたりないんだから！
おまたせ！	おまたせ！	おまたせ！	おまたせ！
おーそーいー！	おーそーいー！	おーそーいー！	おーそーいー！
もう半分できちゃったから！	もう半分できちゃったから！	もう半分できちゃったから！	もう半分できちゃったから！
それじゃあやっちゃおう！	それじゃあやっちゃおう！	それじゃあやっちゃおう！	それじゃあやっちゃおう！
できた！	できた！	できた！	できた！
できた？	できた？	できた？	できた？
まだよ！	まだよ！	まだよ！	まだよ！
まだ頭がないじゃないの！	まだ頭がないじゃないの！	まだ頭がないじゃないの！	まだ頭がないじゃないの！
これじゃ世界一なんていえない！	これじゃ世界一なんていえない！	これじゃ世界一なんていえない！	これじゃ世界一なんていえない！
うーんどうしよう	うーんどうしよう	うーんどうしよう	うーんどうしよう
そうだ！	そうだ！	そうだ！	そうだ！
ねえこれ貸して	ねえこれ貸して	ねえこれ貸して	ねえこれ貸して
大丈夫よ	大丈夫よ	大丈夫よ	大丈夫よ
前にもやったから！	前にもやったから！	前にもやったから！	前にもやったから！
私ってほんと達人！	私ってほんと達人！	私ってほんと達人！	私ってほんと達人！
なんか気持ち悪い	なんか気持ち悪い	なんか気持ち悪い	なんか気持ち悪い
じゃあそれ、のせて！	じゃあそれ、のせて！	じゃあそれ、のせて！	じゃあそれ、のせて！
えーい	えーい	えーい	えーい
うーん	うーん	うーん	うーん
まあまあ	まあまあ	まあまあ	まあまあ
まあまあまあ！	まあまあまあ！	まあまあまあ！	まあまあまあ！
これよこれ！	これよこれ！	これよこれ！	これよこれ！
最高だわ！	最高だわ！	最高だわ！	最高だわ！
すごいね	すごいね	すごいね	すごいね
ごめんね	ごめんね	ごめんね	ごめんね
いいよ	いいよ	いいよ	いいよ
ごめんね	ごめんね	ごめんね	ごめんね
いいよ	いいよ	いいよ	いいよ
お腹すいちゃったから帰る	お腹すいちゃったから帰る	お腹すいちゃったから帰る	お腹すいちゃったから帰る
私も！	私も！	私も！	私も！
うん	うん	うん	うん
じゃあね	じゃあね	じゃあね	じゃあね
またねー	またねー	またねー	またねー
これあげる！	これあげる！	これあげる！	これあげる！
いいの？	いいの？	いいの？	いいの？
友達だから！	友達だから！	友達だから！	友達だから！
また遊ぼうね	また遊ぼうね	また遊ぼうね	また遊ぼうね
うん	うん	うん	うん
きれい	きれい	きれい	きれい
なによ！	なによ！	なによ！	なによ！
私の言うことがわからない？	私の言うことがわからない？	私の言うことがわからない？	私の言うことがわからない？
馬鹿じゃないの？	馬鹿じゃないの？	馬鹿じゃないの？	馬鹿じゃないの？
ニホンゴわからないんですかー？	ニホンゴわからないんですかー？	ニホンゴわからないんですかー？	ニホンゴわからないんですかー？
へーばかだー、ばかなんだー！	へーばかだー、ばかなんだー！	へーばかだー、ばかなんだー！	へーばかだー、ばかなんだー！
ほらほらできた！	ほらほらできた！	ほらほらできた！	ほらほらできた！
すごでしょ？	すごでしょ？	すごでしょ？	すごでしょ？
すごいでしょすごいでしょ？	すごいでしょすごいでしょ？	すごいでしょすごいでしょ？	すごいでしょすごいでしょ？
............	............	............	............
なんで！？	なんで！？	なんで！？	なんで！？
すごいでしょ！？	すごいでしょ！？	すごいでしょ！？	すごいでしょ！？
すごいって言え！	すごいって言え！	すごいって言え！	すごいって言え！
言えよ！	言えよ！	言えよ！	言えよ！
だいくさんごっこ？	だいくさんごっこ？	だいくさんごっこ？	だいくさんごっこ？
わかしもいれて！	わかしもいれて！	わかしもいれて！	わかしもいれて！
............なんで？	............なんで？	............なんで？	............なんで？
なんで！	なんで！	なんで！	なんで！
ずるいずるいずるいずるい	ずるいずるいずるいずるい	ずるいずるいずるいずるい	ずるいずるいずるいずるい
なんでわたしはだめなの！	なんでわたしはだめなの！	なんでわたしはだめなの！	なんでわたしはだめなの！
なんでこの子はいいの！	なんでこの子はいいの！	なんでこの子はいいの！	なんでこの子はいいの！
わたしよりへたっぴなのに！	わたしよりへたっぴなのに！	わたしよりへたっぴなのに！	わたしよりへたっぴなのに！
私のが一番だったの！？	私のが一番だったの！？	私のが一番だったの！？	私のが一番だったの！？
やったあ！	やったあ！	やったあ！	やったあ！
うれしい！	うれしい！	うれしい！	うれしい！
あのね、おねえちゃんが教えてくれたから上手にできたの！	あのね、おねえちゃんが教えてくれたから上手にできたの！	あのね、おねえちゃんが教えてくれたから上手にできたの！	あのね、おねえちゃんが教えてくれたから上手にできたの！
おねえちゃん大好き	おねえちゃん大好き	おねえちゃん大好き	おねえちゃん大好き
ねえねえおねえちゃん	ねえねえおねえちゃん	ねえねえおねえちゃん	ねえねえおねえちゃん
いまお人形作ってるんだけど	いまお人形作ってるんだけど	いまお人形作ってるんだけど	いまお人形作ってるんだけど
おめめがね？	おめめがね？	おめめがね？	おめめがね？
おめめをどうしたらいいかわからないの	おめめをどうしたらいいかわからないの	おめめをどうしたらいいかわからないの	おめめをどうしたらいいかわからないの
おねえちゃんのもらっていーい？	おねえちゃんのもらっていーい？	おねえちゃんのもらっていーい？	おねえちゃんのもらっていーい？
だめなの？	だめなの？	だめなの？	だめなの？
なんで	なんで	なんで	なんで
ねえおねーちゃーん	ねえおねーちゃーん	ねえおねーちゃーん	ねえおねーちゃーん
きょうも手伝ってくれないの？	きょうも手伝ってくれないの？	きょうも手伝ってくれないの？	きょうも手伝ってくれないの？
なんで？	なんで？	なんで？	なんで？
そんなのあとでいいじゃない	そんなのあとでいいじゃない	そんなのあとでいいじゃない	そんなのあとでいいじゃない
............	............	............	............
ごめんなさい	ごめんなさい	ごめんなさい	ごめんなさい
もう達人だから、おねえちゃん教えてくれないんだって	もう達人だから、おねえちゃん教えてくれないんだって	もう達人だから、おねえちゃん教えてくれないんだって	もう達人だから、おねえちゃん教えてくれないんだって
もうおねえちゃんと遊べないの？	もうおねえちゃんと遊べないの？	もうおねえちゃんと遊べないの？	もうおねえちゃんと遊べないの？
じゃあべつに達人なんてならなくてもよかったのに	じゃあべつに達人なんてならなくてもよかったのに	じゃあべつに達人なんてならなくてもよかったのに	じゃあべつに達人なんてならなくてもよかったのに
おねえちゃん！	おねえちゃん！	おねえちゃん！	おねえちゃん！
みてみてクッキー！	みてみてクッキー！	みてみてクッキー！	みてみてクッキー！
ぜんぶじぶんでやったのよ！	ぜんぶじぶんでやったのよ！	ぜんぶじぶんでやったのよ！	ぜんぶじぶんでやったのよ！
え……	え……	え……	え……
だれに教わったの？	だれに教わったの？	だれに教わったの？	だれに教わったの？
んーん！	んーん！	んーん！	んーん！
ご本を読んで作ったのよ！	ご本を読んで作ったのよ！	ご本を読んで作ったのよ！	ご本を読んで作ったのよ！
そう、すごいわね	そう、すごいわね	そう、すごいわね	そう、すごいわね
めしあがれ！	めしあがれ！	めしあがれ！	めしあがれ！
え？	え？	え？	え？
めしあがれ！	めしあがれ！	めしあがれ！	めしあがれ！
おなかすいてないから……	おなかすいてないから……	おなかすいてないから……	おなかすいてないから……
夕ご飯食べられなくなっちゃうし	夕ご飯食べられなくなっちゃうし	夕ご飯食べられなくなっちゃうし	夕ご飯食べられなくなっちゃうし
うん、だから一枚だけね！	うん、だから一枚だけね！	うん、だから一枚だけね！	うん、だから一枚だけね！
ありがとう	ありがとう	ありがとう	ありがとう
おいしいわ	おいしいわ	おいしいわ	おいしいわ
いままで食べたことないくらい	いままで食べたことないくらい	いままで食べたことないくらい	いままで食べたことないくらい
ほんとお！	ほんとお！	ほんとお！	ほんとお！
はじめてなのに上手にできた！	はじめてなのに上手にできた！	はじめてなのに上手にできた！	はじめてなのに上手にできた！
そうね、あなたは何でも上手ね	そうね、あなたは何でも上手ね	そうね、あなたは何でも上手ね	そうね、あなたは何でも上手ね
えへへ	えへへ	えへへ	えへへ
えらい？	えらい？	えらい？	えらい？
そうね、えらいわ	そうね、えらいわ	そうね、えらいわ	そうね、えらいわ
えへへへ	えへへへ	えへへへ	えへへへ
もっといっぱいつくらなきゃ！	もっといっぱいつくらなきゃ！	もっといっぱいつくらなきゃ！	もっといっぱいつくらなきゃ！
わたしなんでもつくるんだ！	わたしなんでもつくるんだ！	わたしなんでもつくるんだ！	わたしなんでもつくるんだ！
この青い石……	この青い石……	この青い石……	この青い石……
なにかしってるの？	なんていうの？	なんていうの？	なんていうの？
宝石だよ！	宝石だよ！	宝石だよ！	宝石だよ！
なんていう宝石？	なんていう宝石？	なんていう宝石？	なんていう宝石？
えーっと............	えーっと............	えーっと............	えーっと............
ブルー............	ブルー............	ブルー............	ブルー............
ブルー？	ブルー？	ブルー？	ブルー？
ブルートパーズだ！	ブルートパーズだ！	ブルートパーズだ！	ブルートパーズだ！
へーっ	へーっ	へーっ	へーっ
えーっとね、これはね	えーっとね、これはね	えーっとね、これはね	えーっとね、これはね
この宝石は............	この宝石は............	この宝石は............	この宝石は............
知らないの？	知らないの？	知らないの？	知らないの？
知ってるもん！	知ってるもん！	知ってるもん！	知ってるもん！
これはファイアーレッドって言うの！	これはファイアーレッドって言うの！	これはファイアーレッドって言うの！	これはファイアーレッドって言うの！
ふーん	ふーん	ふーん	ふーん
えーっとね、これはね	えーっとね、これはね	えーっとね、これはね	えーっとね、これはね
この宝石は............	この宝石は............	この宝石は............	この宝石は............
知らないの？	知らないの？	知らないの？	知らないの？
知ってるもん！	知ってるもん！	知ってるもん！	知ってるもん！
これはファイアーレッドって言うの！	これはファイアーレッドって言うの！	これはファイアーレッドって言うの！	これはファイアーレッドって言うの！
ふーん	ふーん	ふーん	ふーん
えーっとね、これはね	えーっとね、これはね	えーっとね、これはね	えーっとね、これはね
この宝石は............	この宝石は............	この宝石は............	この宝石は............
知らないの？	知らないの？	知らないの？	知らないの？
知ってるもん！	知ってるもん！	知ってるもん！	知ってるもん！
これはファイアーレッドって言うの！	これはファイアーレッドって言うの！	これはファイアーレッドって言うの！	これはファイアーレッドって言うの！
ふーん	ふーん	ふーん	ふーん
あった！	見つけた	見つけた	見つけた
シャベル持ってきてよかった	シャベルもらってよかった	シャベルもらってよかった	シャベルもらってよかった
あった！	見つけた	見つけた	見つけた
思ったより重たい	思ったより重たい	思ったより重たい	思ったより重たい
早く完成させなきゃ！	やっと完成しそう！	やっと完成しそう！	やっと完成しそう！
やっと完成ね！	やっと完成ね！	やっと完成ね！	やっと完成ね！
仕上げはお願いね！	仕上げはお願いね！	仕上げはお願いね！	仕上げはお願いね！
ふわー	ふわー	ふわー	ふわー
おはよう	おはよう	おはよう	おはよう
あれ？	あれ？	あれ？	あれ？
うーん	うーん	うーん	うーん
おめめがいてて	おめめが痛い！	おめめが痛い！	おめめが痛い！
どうしちゃったんだろう	どうしちゃったんだろう	どうしちゃったんだろう	どうしちゃったんだろう
まあ！	まあ！	まあ！	まあ！
目が覚めたのねえ！	目が覚めたのねえ！	目が覚めたのねえ！	目が覚めたのねえ！
え？	え？	え？	え？
おねえちゃん！	おねえちゃん！	おねえちゃん！	おねえちゃん！
よかったあ	よかったあ	よかったあ	よかったあ
待ってらっしゃい	待ってらっしゃい	待ってらっしゃい	待ってらっしゃい
いまご飯を持ってくるわね	いまご飯を持ってくるわね	いまご飯を持ってくるわね	いまご飯を持ってくるわね
それより	それより	それより	それより
みんなは？	みんなは？	みんなは？	みんなは？
みんな？	みんな？	みんな？	みんな？
みんなってだれのこと？	みんなってだれのこと？	みんなってだれのこと？	みんなってだれのこと？
みんなはみんなよ	みんなはみんなよ	みんなはみんなよ	みんなはみんなよ
……	……	……	……
わからないわ	わからないわ	わからないわ	わからないわ
夢でも見てたんじゃないの	夢でも見てたんじゃないの	夢でも見てたんじゃないの	夢でも見てたんじゃないの
夢じゃないよ！	夢じゃないよ！	夢じゃないよ！	夢じゃないよ！
でもお名前もわからないんでしょう？	でもお名前もわからないんでしょう？	でもお名前もわからないんでしょう？	でもお名前もわからないんでしょう？
わかるよ！	わかるよ！	わかるよ！	わかるよ！
それじゃあ言ってごらんなさい	それじゃあ言ってごらんなさい	それじゃあ言ってごらんなさい	それじゃあ言ってごらんなさい
......	......	......	......
ほら言えないでしょう	ほら言えないでしょう	ほら言えないでしょう	ほら言えないでしょう
もういい！	もういい！	もういい！	もういい！
お友達に会いに行くわ！	お友達に会いに行くわ！	お友達に会いに行くわ！	お友達に会いに行くわ！
お友達？	お友達？	お友達？	お友達？
お友達なんていないでしょう、あなた	お友達なんていないでしょう、あなた	お友達なんていないでしょう、あなた	お友達なんていないでしょう、あなた
いるもん	いるもん	いるもん	いるもん
友達いるもん！	友達いるもん！	友達いるもん！	友達いるもん！
あなたに友達なんかいるわけないでしょ	あなたに友達なんかいるわけないでしょ	あなたに友達なんかいるわけないでしょ	あなたに友達なんかいるわけないでしょ
......	......	......	......
じゃあ外見て	じゃあ外見て	じゃあ外見て	じゃあ外見て
はあ	はあ	はあ	はあ
それで？	それで？	それで？	それで？
何も見えないわ	何も見えないわ	何も見えないわ	何も見えないわ
ほらそこよ	ほらそこよ	ほらそこよ	ほらそこよ
そこのずーっと下よ！	そこのずーっと下よ！	そこのずーっと下よ！	そこのずーっと下よ！
またへんなとこへ来ちゃったわ	またへんなとこへ来ちゃったわ	またへんなとこへ来ちゃったわ	またへんなとこへ来ちゃったわ
蓮子ともはぐれたし	蓮子ともはぐれたし	蓮子ともはぐれたし	蓮子ともはぐれたし
参ったわね	参ったわね	参ったわね	参ったわね
うーん	うーん	うーん	うーん
まあゆっくり行きましょう	まあゆっくり行きましょう	まあゆっくり行きましょう	まあゆっくり行きましょう
あら？	あら？	あら？	あら？
なにかしら	なにかしら	なにかしら	なにかしら
暗くてよく見えないわ	暗くてよく見えないわ	暗くてよく見えないわ	暗くてよく見えないわ
うーん	うーん	うーん	うーん
う！	う！	う！	う！
なにこれ	なにこれ	なにこれ	なにこれ
うう	うう	うう	うう
疲れた	疲れたわ	やっちゃった	やっちゃった
ここはどこ	どこかしら	どこかしら	どこかしら
ううっ	目が見えない	目が見えない	目が見えない
なんで？	なんで？	なんで？	なんで？
ひとだ！	人だわ！	人だわ！	人だわ！
うーん	うーん	うーん	うーん
助けなきゃ	助けなきゃ	助けなきゃ	助けなきゃ
たすけたらともだちだもん	助けたんだから友達よね	助けたんだから友達よね	助けたんだから友達よね
ねえ大丈夫？	ねえ大丈夫？	ねえ大丈夫？	ねえ大丈夫？
やめて！	やめて！	やめて！	やめて！
頭が痛いの	頭が痛いの	頭が痛いの	頭が痛いの
大丈夫？	大丈夫？	大丈夫？	大丈夫？
ええ	ええ	ええ	ええ
あなたはここの子かしら	あなたはここの子かしら	あなたはここの子かしら	あなたはここの子かしら
そうだよ	ここって？	ここって？	ここって？
竹林で迷って困ってたの	竹林で迷って困ってたの	竹林で迷って困ってたの	竹林で迷って困ってたの
へんな薬で頭が痛いし	へんな薬で頭が痛いし	へんな薬で頭が痛いし	へんな薬で頭が痛いし
あっこれわたしの！	これ私のよ	これ私のよ	これ私のよ
空っぽになってる	すっからかんだわ	全部使ったの？	全部使ったの？
ラベルを見ようとしたら液が漏れてね	ラベルを見ようとしたら液が漏れてね	ラベルを見ようとしたら液が漏れてね	ラベルを見ようとしたら液が漏れてね
これがなにか知ってるの？	これがなにか知ってるの？	これがなにか知ってるの？	これがなにか知ってるの？
目薬なの	目薬なの	目薬なの	目薬なの
良く見えるでしょ	良く見えるでしょ	良く見えるでしょ	良く見えるでしょ
ええ、見えちゃいけないものまで見えそう	ええ、見えちゃいけないものまで見えそう	ええ、見えちゃいけないものまで見えそう	ええ、見えちゃいけないものまで見えそう
すごいでしょ	すごいでしょ	すごいでしょ	すごいでしょ
あなた名前は？	あなた名前は？	あなた名前は？	あなた名前は？
わたし？	わたし？	わたし？	わたし？
わたしは	わたしは	わたしは	わたしは
こいし	こいし	こいし	こいし
古明地こいし	古明地こいし	古明地こいし	古明地こいし
こいし	こいし	こいし	こいし
いいね	いいね	いいね	いいね
私はメリーよ	私はメリーよ	私はメリーよ	私はメリーよ
マエリベリー・ハーン	マエリベリー・ハーン	マエリベリー・ハーン	マエリベリー・ハーン
変な名前	変な名前	変な名前	変な名前
ふふ、そうね	ふふ、そうね	ふふ、そうね	ふふ、そうね
私友達とはぐれたの	私友達とはぐれたの	私友達とはぐれたの	私友達とはぐれたの
一緒に探してくれる？	一緒に探してくれる？	一緒に探してくれる？	一緒に探してくれる？
わかった	わかった	わかった	わかった
もう友達だもんね	もう友達だもんね	もう友達だもんね	もう友達だもんね
ねえねえ、友達っていい子？	ねえねえ、友達っていい子？	ねえねえ、友達っていい子？	ねえねえ、友達っていい子？
え？	え？	え？	え？
そうね、おおむね	そうね、おおむね	そうね、おおむね	そうね、おおむね
おおむねかー	おおむねかー	おおむねかー	おおむねかー
いいね	いいね	いいね	いいね
あ！	あら	あら	あら
なにこれ	なにかな	なんだろう	なんだろう
まあ、カセットテープ！	まあ、カセットテープ！	まあ、カセットテープ！	まあ、カセットテープ！
なにそれ	なにそれ	なにそれ	なにそれ
これに音を録音して再生できるのよ	これに音を録音して再生できるのよ	これに音を録音して再生できるのよ	これに音を録音して再生できるのよ
探していたの	探していたの	探していたの	探していたの
こないだ落としたのね	こないだ落としたのね	こないだ落としたのね	こないだ落としたのね
録音てなに	録音って？	録音ってどういう意味？	録音ってどういう意味？
......	......	......	......
そうよね	そうよね	そうよね	そうよね
この中に音をためておいて、あとから聞けるのよ	この中に音をためておいて、あとから聞けるのよ	この中に音をためておいて、あとから聞けるのよ	この中に音をためておいて、あとから聞けるのよ
レコードみたい！	レコードみたい！	レコードみたい！	レコードみたい！
レコードは知ってるのね	レコードは知ってるのね	レコードは知ってるのね	レコードは知ってるのね
見たことあるから	見たことあるから	友達が持ってた	友達が持ってた
使ってみて！	やってみて！	やってみて！	やってみて！
いまはできないわ	いまはできないわ	いまはできないわ	いまはできないわ
どうして？	どうして？	どうして？	どうして？
レコードにも蓄音機がいるでしょ？	レコードにも蓄音機がいるでしょ？	レコードにも蓄音機がいるでしょ？	レコードにも蓄音機がいるでしょ？
これは蓄音機。円盤がいるの	これは蓄音機。円盤がいるの	これは蓄音機。円盤がいるの	これは蓄音機。円盤がいるの
もってないの？	もってないの？	もってないの？	もってないの？
いまは持ってないわ	いまは持ってないわ	いまは持ってないわ	いまは持ってないわ
じゃあ探そうよ！	じゃあ探そうよ！	残念	残念
またみっけた！	またあった！	またあった！	またあった！
竹林の中にテープ？	竹林の中にテープ？	竹林の中にテープ？	竹林の中にテープ？
へんなの	へんなの	へんなの	へんなの
誰かが落としたのかな	誰かが落としたのかな	誰かが落としたのかな	誰かが落としたのかな
うーんどうかな	うーんどうかな	うーんどうかな	うーんどうかな
蓮子のじゃあないと思うんだけど	蓮子のじゃあないと思うんだけど	蓮子のじゃあないと思うんだけど	蓮子のじゃあないと思うんだけど
蓮子って？	蓮子って？	蓮子って？	蓮子って？
さがしてるお友達のこと？	さがしてるお友達のこと？	さがしてるお友達のこと？	さがしてるお友達のこと？
そうよ	そうよ	そうよ	そうよ
れんこんさんみたい！	蓮根みたい！へんなの	蓮根みたい！へんなの	蓮根みたい！へんなの
本当にそういう字を書くのよ	本当にそういう字を書くのよ	本当にそういう字を書くのよ	本当にそういう字を書くのよ
えっ	えっ	えっ	えっ
......	......	......	......
どういうこと	......	......	......
ごめん、難しかったわね	ごめん、難しかったわね	ごめん、難しかったわね	ごめん、難しかったわね
今のは忘れて	今のは忘れて	今のは忘れて	今のは忘れて
蓮根がお友達だなんて	蓮根がお友達だなんて	蓮根がお友達だなんて	蓮根がお友達だなんて
忘れられないよ	忘れられないよ	忘れられないよ	忘れられないよ
......	......	......	......
......	......	......	......
あなたにはどんな友達がいるの？	あなたにはどんな友達がいるの？	あなたにはどんな友達がいるの？	あなたにはどんな友達がいるの？
わたし？	わたし？	わたし？	わたし？
いっぱい	いっぱい	こないだ遊んだ子は一緒に雪だるまつくったの	こないだ遊んだ子は一緒に雪だるまつくったの
えっとね、	えっとね、	あたま足りない子になったから	あたま足りない子になったから
えっと......	えっと......	その子の頭をはねてね	その子の頭をはねてね
いっぱいいるよ	いっぱいいるよ	雪だるまの頭にしたの	雪だるまの頭にしたの
......	......	......	......
そうなんだ	そうなんだ	そうなんだ	そうなんだ
うーんいないわねえ	うーんいないわねえ	うーんいないわねえ	うーんいないわねえ
友達？	友達？	友達？	友達？
そう	そう	そう	そう
この辺にいるような気はするんだけどなあ	この辺にいるような気はするんだけどなあ	この辺にいるような気はするんだけどなあ	この辺にいるような気はするんだけどなあ
れんこー、って叫んでくれる？	れんこー、って叫んでくれる？	れんこー、って叫んでくれる？	れんこー、って叫んでくれる？
私喉が悪くて	私喉が悪くて	私喉が悪くて	私喉が悪くて
いいよ	いいよ	いいよ	いいよ
れんこーっ	れーんーこー！	れーんーこー！	れーんーこー！
......	......	......	......
いないね	いないね	いないね	いないね
いないね	いないね	いないね	いないね
携帯もないしなあ	携帯もないしなあ	携帯もないしなあ	携帯もないしなあ
なにかいい方法ないかしら	なにかいい方法ないかしら	なにかいい方法ないかしら	なにかいい方法ないかしら
あれ？	あれ？	あれ？	あれ？
これひょっとして	これひょっとして	これひょっとして	これひょっとして
あ！	あ！	あ！	あ！
それがさっき言ってたものよ	それがさっき言ってたものよ	それがさっき言ってたものよ	それがさっき言ってたものよ
お友達？	これが友達なの？	これが友達なの？	これが友達なの？
......そっちじゃなくて	......そっちじゃなくて	......そっちじゃなくて	......そっちじゃなくて
カセットテープを流す機械	カセットテープを流す機械	カセットテープを流す機械	カセットテープを流す機械
これがそれ？	これがそれ？	これがそれ？	これがそれ？
ちっちゃいなー	ちっちゃいなー	ちっちゃいなー	ちっちゃいなー
しばらく貸してあげるわ	しばらく貸してあげるわ	しばらく貸してあげるわ	しばらく貸してあげるわ
ちょっと待って	ちょっと待って	ちょっと待って	ちょっと待って
なに？	なに？	なに？	なに？
蓮子を見つけないと	蓮子を見つけないと	蓮子を見つけないと	蓮子を見つけないと
これ以上進むとはぐれたところからどんどん離れちゃう	これ以上進むとはぐれたところからどんどん離れちゃう	これ以上進むとはぐれたところからどんどん離れちゃう	これ以上進むとはぐれたところからどんどん離れちゃう
わかった	わかった	わかった	わかった
これなに？	これなに？	これなに？	これなに？
チャルメラね	チャルメラね	チャルメラね	チャルメラね
チャルメラって？	チャルメラって？	チャルメラって？	チャルメラって？
わからない	わからない	わからない	わからない
ラッパみたいなものよ	ラッパみたいなものよ	ラッパみたいなものよ	ラッパみたいなものよ
ふーん	ふーん	ふーん	ふーん
あれ？	あれ？	あれ？	あれ？
メリーみっけ	メリーみっけ	メリーみっけ	メリーみっけ
あっ蓮子！	あっ蓮子！	あっ蓮子！	あっ蓮子！
よかった	よかった	よかった	よかった
どこ行ってたのよ	どこ行ってたのよ	どこ行ってたのよ	どこ行ってたのよ
こっちのセリフよ	こっちのセリフよ	こっちのセリフよ	こっちのセリフよ
手分けして探そうなんて言って	手分けして探そうなんて言って	手分けして探そうなんて言って	手分けして探そうなんて言って
ぱーっと走っていくのがいけないんじゃない	ぱーっと走っていくのがいけないんじゃない	ぱーっと走っていくのがいけないんじゃない	ぱーっと走っていくのがいけないんじゃない
それよりチャルメラの音が聞こえたんだけど	それよりチャルメラの音が聞こえたんだけど	それよりチャルメラの音が聞こえたんだけど	それよりチャルメラの音が聞こえたんだけど
てっきり現実に戻れると思っていたのに	てっきり現実に戻れると思っていたのに	てっきり現実に戻れると思っていたのに	てっきり現実に戻れると思っていたのに
ここは現実よ	ここは現実よ	ここは現実よ	ここは現実よ
チャルメラは偽物だけど	チャルメラは偽物だけど	チャルメラは偽物だけど	チャルメラは偽物だけど
鴨川の屋台ラーメンかと思ったのに	鴨川の屋台ラーメンかと思ったのに	鴨川の屋台ラーメンかと思ったのに	鴨川の屋台ラーメンかと思ったのに
残念ね	残念ね	残念ね	残念ね
このひとがともだち？	このひとがともだち？	このひとがともだち？	このひとがともだち？
そうよ	そうよ	そうよ	そうよ
......	......	......	......
......	......	......	......
ねえ大丈夫なの？	ねえ大丈夫なの？	ねえ大丈夫なの？	ねえ大丈夫なの？
なにが？	なにが？	なにが？	なにが？
なんだか変よ	なんだか変よ	なんだか変よ	なんだか変よ
そうかしら	そうかしら	そうかしら	そうかしら
まあいいわ、先に進みましょ	まあいいわ、先に進みましょ	まあいいわ、先に進みましょ	まあいいわ、先に進みましょ
わたしもいい？	ついて行ってもいい？	ついて行ってもいい？	ついて行ってもいい？
いいわよ	いいわよ	いいわよ	いいわよ
......	......	......	......
私先に行くわね	私先に行くわね	私先に行くわね	私先に行くわね
ねえねえ	ねえねえ	ねえねえ	ねえねえ
久しぶり！	久しぶり！	久しぶり！	久しぶり！
......	......	......	......
誰？	誰？	誰？	誰？
こないだ会ったじゃない	こないだ会ったじゃない	こないだ会ったじゃない	こないだ会ったじゃない
いや	いや	いや	いや
知らない	知らない	知らない	知らない
なんで？	なんで？	なんで？	なんで？
お前、気味が悪いぞ	お前、気味が悪いぞ	お前、気味が悪いぞ	お前、気味が悪いぞ
ねえねえいじわる言わないで	いたずらのつもりなの	いじわるはやめて	いじわるはやめて
お友達でしょ	ともだちだよね	ともだちだよね	ともだちだよね
うるさいなあ	うるさいなあ	うるさいなあ	うるさいなあ
あっち行けよ	あっち行けよ	あっち行けよ	あっち行けよ
ね本当に友達なの？	ね本当に友達なの？	ね本当に友達なの？	ね本当に友達なの？
そうよ	そう	そうだと思う	そうだと思う
そうなの	そうなの	そうなの	そうなの
ねえ、お友達いっぱいいるの	ねえ、お友達いっぱいいるの	ねえ、お友達いっぱいいるの	ねえ、お友達いっぱいいるの
あんまりいないわね	あんまりいないわね	あんまりいないわね	あんまりいないわね
私はたくさんいるよ	私はたくさんいるよ	私はたくさんいるよ	私はたくさんいるよ
素敵ね	素敵ね	素敵ね	素敵ね
なんて子？	なんて子？	なんて子？	なんて子？
なにが？	なにが？	なにが？	なにが？
お友達の名前は？	お友達の名前は？	お友達の名前は？	お友達の名前は？
どうしたの	どうしたの	どうしたの	どうしたの
なんでもない	なんでもない	なんでもない	なんでもない
ねえねえ	ねえねえ	ねえ	ねえ
なんだい？	なんだい？	なんだい？	なんだい？
竹林から出たいなら道案内してやるから待ってろ	竹林から出たいなら道案内してやるから待ってろ	竹林から出たいなら道案内してやるから待ってろ	竹林から出たいなら道案内してやるから待ってろ
そうじゃないの	そうじゃないの	そうじゃないの	そうじゃないの
診療所に行きたいのか？	診療所に行きたいのか？	診療所に行きたいのか？	診療所に行きたいのか？
それって病院のことでしょ	それって病院のことでしょ	それって病院のことでしょ	それって病院のことでしょ
そうじゃないの	そうじゃないの	そうじゃないの	そうじゃないの
じゃあなんだよ	じゃあなんだよ	じゃあなんだよ	じゃあなんだよ
あっちに邪魔なのがいるの	あっちに邪魔なのがいるの	あっちに邪魔なのがいるの	あっちに邪魔なのがいるの
あー	あー	あー	あー
あいつな	あいつな	あいつな	あいつな
でもあっちへ行っても何もないぞ	でもあっちへ行っても何もないぞ	でもあっちへ行っても何もないぞ	でもあっちへ行っても何もないぞ
でも友達が行きたいって言ってるの	でも友達が行きたいって言ってるの	でも友達が行きたいって言ってるの	でも友達が行きたいって言ってるの
ふーん	ふーん	ふーん	ふーん
まあいいさ	まあいいさ	まあいいさ	まあいいさ
あっちには――	あっちには――	あっちには――	あっちには――
何もないがあるからな	何もないがあるからな	何もないがあるからな	何もないがあるからな
それが好きな奴もいる	それが好きな奴もいる	それが好きな奴もいる	それが好きな奴もいる
よくわかんない	よくわかんない	よくわかんない	よくわかんない
そうだろうな	そうだろうな	そうだろうな	そうだろうな
何もないをありがたがるのはな	何もないをありがたがるのはな	何もないをありがたがるのはな	何もないをありがたがるのはな
自分の中にたくさん何かがあるやつだ	自分の中にたくさん何かがあるやつだ	自分の中にたくさん何かがあるやつだ	自分の中にたくさん何かがあるやつだ
でも見たところ、お前空っぽだろー？	でも見たところ、お前空っぽだろー？	でも見たところ、お前空っぽだろー？	でも見たところ、お前空っぽだろー？
......	......	......	......
ちがうよ	わかんない	わかんない	わかんない
もう友達だよね	もう友達だよね	もう友達だよね	もう友達だよね
違うぞ	違うぞ	違うぞ	違うぞ
とっとと行け	とっとと行け	とっとと行け	とっとと行け
木ばっかり！	変な木ばっかり	変な木ばっかりね	変な木ばっかりね
竹って言うのよ	竹って言うのよ	竹って言うのよ	竹って言うのよ
ちょっと疲れたわ	ちょっと疲れたわ	ちょっと疲れたわ	ちょっと疲れたわ
休憩しましょ	休憩しましょ	休憩しましょ	休憩しましょ
うん	わかった	近くを見てくるね	近くを見てくるね
そうだわ	そうだわ	そうだわ	そうだわ
どこかこの辺りにテープを落としたの	どこかこの辺りにテープを落としたの	どこかこの辺りにテープを落としたの	どこかこの辺りにテープを落としたの
新品の――	新品の――	新品の――	新品の――
音の入っていないテープよ	音の入っていないテープよ	音の入っていないテープよ	音の入っていないテープよ
もし見つけたら拾っておいて	もし見つけたら拾っておいて	もし見つけたら拾っておいて	もし見つけたら拾っておいて
わかったー	わかった	わかりました	わかりました
れんこはいいの？	れんこはいいの？	れんこはいいの？	れんこはいいの？
いまはいいわ	いまはいいわ	いまはいいわ	いまはいいわ
好きにさせてあげましょ	好きにさせてあげましょ	好きにさせてあげましょ	好きにさせてあげましょ
あら	あら	あら	あら
見ない顔ね	見ない顔ね	見ない顔ね	見ない顔ね
迷子なの？	迷子なの？	迷子なの？	迷子なの？
違うよ	私は迷子じゃないよ	友達が迷子なの	友達が迷子なの
ふーん	ふーん	ふーん	ふーん
あなたお名前は？	あなたお名前は？	あなたお名前は？	あなたお名前は？
こいし	こいしよ	こいしよ	こいしよ
やっぱり聞かない名前ね	やっぱり聞かない名前ね	やっぱり聞かない名前ね	やっぱり聞かない名前ね
ここから出たいの？	ここから出たいの？	ここから出たいの？	ここから出たいの？
私じゃなくて	私じゃなくて	私じゃなくて	私じゃなくて
友達がね	友達がね	友達がね	友達がね
ふーん	ふーん	ふーん	ふーん
友達は人間なの？	友達は人間なの？	友達は人間なの？	友達は人間なの？
どういうこと？	どういうこと？	どういうこと？	どういうこと？
......人間が友達なの？	......人間が友達なの？	......人間が友達なの？	......人間が友達なの？
そう！	なにが	どういうこと？	どういうこと？
あんた妖怪なんでしょ？	あんた妖怪なんでしょ？	あんた妖怪なんでしょ？	あんた妖怪なんでしょ？
違うよ	違うよ！	いいえ	いいえ
そう？	そう？	そう？	そう？
あなた私より余程妖怪らしいわよ	あなた私より余程妖怪らしいわよ	あなた私より余程妖怪らしいわよ	あなた私より余程妖怪らしいわよ
私は鈴仙よ	私は鈴仙よ	私は鈴仙よ	私は鈴仙よ
もし薬が必要だったらよろしく	もし薬が必要だったらよろしく	もし薬が必要だったらよろしく	もし薬が必要だったらよろしく
薬屋さんなの？	薬屋さんなの？	薬屋さんなの？	薬屋さんなの？
いや、私は薬売り	いや、私は薬売り	いや、私は薬売り	いや、私は薬売り
薬を作っているお医者先生はまた別	薬を作っているお医者先生はまた別	薬を作っているお医者先生はまた別	薬を作っているお医者先生はまた別
ふーん	ふーん	ふーん	ふーん
人間用の薬がほとんどだけどね	人間用の薬がほとんどだけどね	人間用の薬がほとんどだけどね	人間用の薬がほとんどだけどね
なにこれ	なにこれ	なにこれ	なにこれ
おや	おや	おや	おや
あなたは？	あなたは？	あなたは？	あなたは？
わたし？	わたし？	わたし？	わたし？
わたしはこいし	わたしはこいし	わたしはこいし	わたしはこいし
こいし......	こいし......	こいし......	こいし......
あなたは何処へ向かっているのですか	あなたは何処へ向かっているのですか	あなたは何処へ向かっているのですか	あなたは何処へ向かっているのですか
この先	先へ行きたいんだけど	先へ行きたいんだけど	先へ行きたいんだけど
いいえ	いいえ	いいえ	いいえ
あなたは何を為そうとしているのですか	あなたは何を為そうとしているのですか	あなたは何を為そうとしているのですか	あなたは何を為そうとしているのですか
なに？	わかんない	どういうこと？	どういうこと？
私はこの先の「虚無」に人が迷い込まぬよう見守っています	私はこの先の「虚無」に人が迷い込まぬよう見守っています	私はこの先の「虚無」に人が迷い込まぬよう見守っています	私はこの先の「虚無」に人が迷い込まぬよう見守っています
知恵持たずして生きるは磁針無くして海漕ぎ出づるに同じ	知恵持たずして生きるは磁針無くして海漕ぎ出づるに同じ	知恵持たずして生きるは磁針無くして海漕ぎ出づるに同じ	知恵持たずして生きるは磁針無くして海漕ぎ出づるに同じ
げっ	げっ	げっ	げっ
いま地蔵がしゃべった？	いま地蔵がしゃべった？	いま地蔵がしゃべった？	いま地蔵がしゃべった？
いよいよ奇怪ね	いよいよ奇怪ね	いよいよ奇怪ね	いよいよ奇怪ね
いまの意味わかった？	今の話聞いてた？	今の話聞いてた？	今の話聞いてた？
とりあえずあたりを調べなきゃね	とりあえずあたりを調べなきゃね	とりあえずあたりを調べなきゃね	とりあえずあたりを調べなきゃね
......	......	......	......
喋り続けないと静けさで狂いそうだわ	喋り続けないと静けさで狂いそうだわ	喋り続けないと静けさで狂いそうだわ	喋り続けないと静けさで狂いそうだわ
うわ	うわ	うわ	うわ
死んでる	死んじゃってる	死んじゃってる	死んじゃってる
この人たちはもう間に合わない	この人たちはもう間に合わない	この人たちはもう間に合わない	この人たちはもう間に合わない
残念、商機を逸したわ	残念、商機を逸したわ	残念、商機を逸したわ	残念、商機を逸したわ
まいったなー	まいったなー	まいったなー	まいったなー
診療所に来る人間を待ち伏せしてさ	診療所に来る人間を待ち伏せしてさ	診療所に来る人間を待ち伏せしてさ	診療所に来る人間を待ち伏せしてさ
ガッチリ稼ぐつもりだったのに	ガッチリ稼ぐつもりだったのに	ガッチリ稼ぐつもりだったのに	ガッチリ稼ぐつもりだったのに
この人なんで死んだの？	なんで死んじゃったんだろう	なんで死んじゃったんだろう	なんで死んじゃったんだろう
さあ？	さあ？	さあ？	さあ？
あなたはどう思う？	あなたはどう思う？	あなたはどう思う？	あなたはどう思う？
狼に食べられちゃったとか	きっと獣に襲われたのよ	きっと獣に襲われたのよ	きっと獣に襲われたのよ
まあ怖い	まあ怖い	まあ怖い	まあ怖い
違うの？	違うの？	違うの？	違うの？
さあ？	さあ？	さあ？	さあ？
私は別に死んだ人間には興味ないし	私は別に死んだ人間には興味ないし	私は別に死んだ人間には興味ないし	私は別に死んだ人間には興味ないし
気になるなら調べてみたら？	気になるなら調べてみたら？	気になるなら調べてみたら？	気になるなら調べてみたら？
手がかりがあるかも！	お手紙とかないかな	お手紙とかないかな	お手紙とかないかな
自殺ならあるかもね	自殺ならあるかもね	自殺ならあるかもね	自殺ならあるかもね
ここでは珍しいけど	ここでは珍しいけど	ここでは珍しいけど	ここでは珍しいけど
自殺って？	自殺って？	自殺って？	自殺って？
言葉通りよ	言葉通りよ	言葉通りよ	言葉通りよ
自分で自分を殺すの	自分で自分を殺すの	自分で自分を殺すの	自分で自分を殺すの
......	......	......	......
それって痛くないの	痛そうだわ	痛そうだわ	痛そうだわ
さあ	さあ	さあ	さあ
私はできなかったから知らない	私はできなかったから知らない	私はできなかったから知らない	私はできなかったから知らない
あ！	あ！	あ！	あ！
あった！	あった！	あった！	あった！
あれ？	あれ？	あれ？	あれ？
これちがう？	メリーのじゃないかも	メリーのじゃないかも	メリーのじゃないかも
きもちわるい	きもちわるい	きもちわるい	きもちわるい
かみのけぐちゃぐちゃだもん	かみのけぐちゃぐちゃだもん	誰なの？	誰なの？
うちにかえりたい......	うちにかえりたい......	うちにかえりたい......	うちにかえりたい......
くるんじゃなかった	くるんじゃなかった	くるんじゃなかった	くるんじゃなかった
これね！	これね！	これね！	これね！
メリーがまってるわ！	メリーがまってるわ！	メリーがまってるわ！	メリーがまってるわ！
メリー！	メリー！	メリー！	メリー！
見つけたよ！	見つけたよ！	見つけたよ！	見つけたよ！
まあ！	まあ！	まあ！	まあ！
これよ！	これよ！	これよ！	これよ！
どうもありがとう	どうもありがとう	どうもありがとう	どうもありがとう
それじゃあこれに録音をしましょ	それじゃあこれに録音をしましょ	それじゃあこれに録音をしましょ	それじゃあこれに録音をしましょ
機械を返してちょうだい	機械を返してちょうだい	機械を返してちょうだい	機械を返してちょうだい
うん	うん	うん	うん
それじゃあお話して？	それじゃあお話して？	それじゃあお話して？	それじゃあお話して？
え？	え？	え？	え？
こいしちゃんが話したことがこの中に入るのよ	こいしちゃんが話したことがこの中に入るのよ	こいしちゃんが話したことがこの中に入るのよ	こいしちゃんが話したことがこの中に入るのよ
えー	えー	えー	えー
すごい	すごい	すごい	すごい
うふふ	うふふ	うふふ	うふふ
うふふ	うふふ	うふふ	うふふ
ちょっと恥ずかしい？	ちょっと恥ずかしい？	ちょっと恥ずかしい？	ちょっと恥ずかしい？
うん	うん	うん	うん
わたしメリー	わたしメリー	わたしメリー	わたしメリー
あなたお名前は？	あなたお名前は？	あなたお名前は？	あなたお名前は？
こいし	こいしです	こいしです	こいしです
あなたは妖怪？	あなたは妖怪？	あなたは妖怪？	あなたは妖怪？
えっ	えっ	えっ	えっ
よくわからない	わかりません	よくわかりません	よくわかりません
そう	そう	そう	そう
ありがとう	ありがとう	ありがとう	ありがとう
メリーあなた大丈夫なの	メリーあなた大丈夫なの	メリーあなた大丈夫なの	メリーあなた大丈夫なの
さっきから頭痛がするだけ	さっきから頭痛がするだけ	さっきから頭痛がするだけ	さっきから頭痛がするだけ
うう	うう	うう	うう
やっぱり来るべきじゃなかったのよ	やっぱり来るべきじゃなかったのよ	やっぱり来るべきじゃなかったのよ	やっぱり来るべきじゃなかったのよ
でも来たかったから	でも来たかったから	でも来たかったから	でも来たかったから
あなたにもここを見てもらいたくて	あなたにもここを見てもらいたくて	あなたにもここを見てもらいたくて	あなたにもここを見てもらいたくて
それに聞いてちょうだい	それに聞いてちょうだい	それに聞いてちょうだい	それに聞いてちょうだい
「あなたお名前は？」	「あなたお名前は？」	「あなたお名前は？」	「あなたお名前は？」
「こいし」	「こいしです」	「こいしです」	「こいしです」
「あなたは妖怪？」	「あなたは妖怪？」	「あなたは妖怪？」	「あなたは妖怪？」
「えっ」	「えっ」	「えっ」	「えっ」
「よくわからない」	「わかりません」	「よくわかりません」	「よくわかりません」
「そう」	「そう」	「そう」	「そう」
「ありがとう」	「ありがとう」	「ありがとう」	「ありがとう」
......	......	......	......
メリー、あなた疲れているのよ	メリー、あなた疲れているのよ	メリー、あなた疲れているのよ	メリー、あなた疲れているのよ
私にはあなたの声しか聞こえないわ	私にはあなたの声しか聞こえないわ	私にはあなたの声しか聞こえないわ	私にはあなたの声しか聞こえないわ
蓮子、あなたこそ	蓮子、あなたこそ	蓮子、あなたこそ	蓮子、あなたこそ
......	......	......	......
......	......	......	......
ごめんなさい	ごめんなさい	ごめんなさい	ごめんなさい
......	......	......	......
......	......	......	......
痛い！	痛い！	痛い！	痛い！
こいしちゃん何するの！	こいしちゃん何するの！	こいしちゃん何するの！	こいしちゃん何するの！
何？	何？	何？	何？
何なの？	何なの？	何なの？	何なの？
ねえねえ	ねえねえ	ねえねえ	ねえねえ
大丈夫？	大丈夫？	大丈夫？	大丈夫？
いまのはやりすぎよ	いまのはやりすぎよ	いまのはやりすぎよ	いまのはやりすぎよ
ごめんなさい	ごめん	ごめん	ごめん
うう	うう	うう	うう
吐きそう	吐きそう	吐きそう	吐きそう
頭われそう	頭われそう	頭われそう	頭われそう
割れたのは瓶よ	割れたのは瓶よ	割れたのは瓶よ	割れたのは瓶よ
大丈夫？	大丈夫？	大丈夫？	大丈夫？
病院に行きたい	病院に行きたい	病院に行きたい	病院に行きたい
私これ見えてないからね	私これ見えてないからね	私これ見えてないからね	私これ見えてないからね
頑固ね	頑固ね	頑固ね	頑固ね
じゃああなたもあの薬を浴びてからあの子が見えたの？	じゃああなたもあの薬を浴びてからあの子が見えたの？	じゃああなたもあの薬を浴びてからあの子が見えたの？	じゃああなたもあの薬を浴びてからあの子が見えたの？
そう	そう	そう	そう
それってどっちが正しいわけ	それってどっちが正しいわけ	それってどっちが正しいわけ	それってどっちが正しいわけ
......	......	......	......
あの薬で幻覚を見ているとしたら？	あの薬で幻覚を見ているとしたら？	あの薬で幻覚を見ているとしたら？	あの薬で幻覚を見ているとしたら？
でも私にもメリーにも同じ姿が見えているのよ	でも私にもメリーにも同じ姿が見えているのよ	でも私にもメリーにも同じ姿が見えているのよ	でも私にもメリーにも同じ姿が見えているのよ
幻覚なら違うものが見えるはずよ	幻覚なら違うものが見えるはずよ	幻覚なら違うものが見えるはずよ	幻覚なら違うものが見えるはずよ
例えばブーバキキ効果のように文化圏や経験によらない――	例えばブーバキキ効果のように文化圏や経験によらない――	例えばブーバキキ効果のように文化圏や経験によらない――	例えばブーバキキ効果のように文化圏や経験によらない――
人類が普遍的に持つイメージが彼女なのかも	人類が普遍的に持つイメージが彼女なのかも	人類が普遍的に持つイメージが彼女なのかも	人類が普遍的に持つイメージが彼女なのかも
それってすごく――	それってすごく――	それってすごく――	それってすごく――
すごいことよ	すごいことよ	すごいことよ	すごいことよ
ブーバキキは所詮平面図形よ	ブーバキキは所詮平面図形よ	ブーバキキは所詮平面図形よ	ブーバキキは所詮平面図形よ
ええ、あんなに具体的な存在じゃない	ええ、あんなに具体的な存在じゃない	ええ、あんなに具体的な存在じゃない	ええ、あんなに具体的な存在じゃない
彼女はやっぱり本当にいるのかしら	彼女はやっぱり本当にいるのかしら	彼女はやっぱり本当にいるのかしら	彼女はやっぱり本当にいるのかしら
いままでもずっと彼女は存在していて、	いままでもずっと彼女は存在していて、	いままでもずっと彼女は存在していて、	いままでもずっと彼女は存在していて、
あの薬をきっかけに認知できるように――	あの薬をきっかけに認知できるように――	あの薬をきっかけに認知できるように――	あの薬をきっかけに認知できるように――
いや、どういう理屈なんだ	いや、どういう理屈なんだ	いや、どういう理屈なんだ	いや、どういう理屈なんだ
ブーバキキ少女説のほうが説得力あるわ	ブーバキキ少女説のほうが説得力あるわ	ブーバキキ少女説のほうが説得力あるわ	ブーバキキ少女説のほうが説得力あるわ
彼女の名前が気になるの	彼女の名前が気になるの	彼女の名前が気になるの	彼女の名前が気になるの
こいしちゃんって言うのよ	こいしちゃんって言うのよ	こいしちゃんって言うのよ	こいしちゃんって言うのよ
「小石」	「小石」	「小石」	「小石」
変わった名前ね	変わった名前ね	変わった名前ね	変わった名前ね
この現象、唯名論的な所以なのかしら	この現象、唯名論的な所以なのかしら	この現象、唯名論的な所以なのかしら	この現象、唯名論的な所以なのかしら
うーん	うーん	うーん	うーん
小石って名前だから認知の外側に追いやられたっていうの？	小石って名前だから認知の外側に追いやられたっていうの？	小石って名前だから認知の外側に追いやられたっていうの？	小石って名前だから認知の外側に追いやられたっていうの？
誰にも気づかれないから小石だなんて名前を付けたっていうの？	誰にも気づかれないから小石だなんて名前を付けたっていうの？	誰にも気づかれないから小石だなんて名前を付けたっていうの？	誰にも気づかれないから小石だなんて名前を付けたっていうの？
そんな母親がいるっていうの？	そんな母親がいるっていうの？	そんな母親がいるっていうの？	そんな母親がいるっていうの？
......時代ね	......時代ね	......時代ね	......時代ね
そんな時代なんて	そんな時代なんて	そんな時代なんて	そんな時代なんて
この百年間、嫌な時代よ	この百年間、嫌な時代よ	この百年間、嫌な時代よ	この百年間、嫌な時代よ
昔は人って生まれた時から死ぬ時まで同じ生活をしていられたのよ	昔は人って生まれた時から死ぬ時まで同じ生活をしていられたのよ	昔は人って生まれた時から死ぬ時まで同じ生活をしていられたのよ	昔は人って生まれた時から死ぬ時まで同じ生活をしていられたのよ
時代が止まればいいのに	時代が止まればいいのに	時代が止まればいいのに	時代が止まればいいのに
じゃああなたもあの薬を浴びてからあの子が見えたの？	じゃああなたもあの薬を浴びてからあの子が見えたの？	じゃああなたもあの薬を浴びてからあの子が見えたの？	じゃああなたもあの薬を浴びてからあの子が見えたの？
そう	そう	そう	そう
それってどっちが正しいわけ	それってどっちが正しいわけ	それってどっちが正しいわけ	それってどっちが正しいわけ
......	......	......	......
あの薬で幻覚を見ているとしたら？	あの薬で幻覚を見ているとしたら？	あの薬で幻覚を見ているとしたら？	あの薬で幻覚を見ているとしたら？
でも私にもメリーにも同じ姿が見えているのよ	でも私にもメリーにも同じ姿が見えているのよ	でも私にもメリーにも同じ姿が見えているのよ	でも私にもメリーにも同じ姿が見えているのよ
幻覚なら違うものが見えるはずよ	幻覚なら違うものが見えるはずよ	幻覚なら違うものが見えるはずよ	幻覚なら違うものが見えるはずよ
例えばブーバキキ効果のように文化圏や経験によらない――	例えばブーバキキ効果のように文化圏や経験によらない――	例えばブーバキキ効果のように文化圏や経験によらない――	例えばブーバキキ効果のように文化圏や経験によらない――
人類が普遍的に持つイメージが彼女なのかも	人類が普遍的に持つイメージが彼女なのかも	人類が普遍的に持つイメージが彼女なのかも	人類が普遍的に持つイメージが彼女なのかも
それってすごく――	それってすごく――	それってすごく――	それってすごく――
すごいことよ	すごいことよ	すごいことよ	すごいことよ
ブーバキキは所詮平面図形よ	ブーバキキは所詮平面図形よ	ブーバキキは所詮平面図形よ	ブーバキキは所詮平面図形よ
あんなに具体的な存在じゃない	あんなに具体的な存在じゃない	あんなに具体的な存在じゃない	あんなに具体的な存在じゃない
それじゃあ彼女はやっぱり本当にいるのかしら	それじゃあ彼女はやっぱり本当にいるのかしら	それじゃあ彼女はやっぱり本当にいるのかしら	それじゃあ彼女はやっぱり本当にいるのかしら
いままでもずっと彼女は存在していて、	いままでもずっと彼女は存在していて、	いままでもずっと彼女は存在していて、	いままでもずっと彼女は存在していて、
あの薬をきっかけに認知できるように――	あの薬をきっかけに認知できるように――	あの薬をきっかけに認知できるように――	あの薬をきっかけに認知できるように――
いや、どういう理屈なんだ	いや、どういう理屈なんだ	いや、どういう理屈なんだ	いや、どういう理屈なんだ
ブーバキキ少女説のほうが説得力あるわ	ブーバキキ少女説のほうが説得力あるわ	ブーバキキ少女説のほうが説得力あるわ	ブーバキキ少女説のほうが説得力あるわ
彼女の名前が気になるの	彼女の名前が気になるの	彼女の名前が気になるの	彼女の名前が気になるの
こいしちゃんって言うのよ	こいしちゃんって言うのよ	こいしちゃんって言うのよ	こいしちゃんって言うのよ
「小石」	「小石」	「小石」	「小石」
変わった名前ね	変わった名前ね	変わった名前ね	変わった名前ね
この現象、唯名論的な所以なのかしら	この現象、唯名論的な所以なのかしら	この現象、唯名論的な所以なのかしら	この現象、唯名論的な所以なのかしら
うーん	うーん	うーん	うーん
小石って名前だから認知の外側に追いやられたっていうの？	小石って名前だから認知の外側に追いやられたっていうの？	小石って名前だから認知の外側に追いやられたっていうの？	小石って名前だから認知の外側に追いやられたっていうの？
誰にも気づかれないから小石だなんて名前を付けたっていうの？	誰にも気づかれないから小石だなんて名前を付けたっていうの？	誰にも気づかれないから小石だなんて名前を付けたっていうの？	誰にも気づかれないから小石だなんて名前を付けたっていうの？
そんな母親がいるっていうの？	そんな母親がいるっていうの？	そんな母親がいるっていうの？	そんな母親がいるっていうの？
......時代ね	......時代ね	......時代ね	......時代ね
そんな時代なんて	そんな時代なんて	そんな時代なんて	そんな時代なんて
この百年間、嫌な時代よ	この百年間、嫌な時代よ	この百年間、嫌な時代よ	この百年間、嫌な時代よ
昔は人って生まれた時から死ぬ時まで同じ生活をしていられたのよ	昔は人って生まれた時から死ぬ時まで同じ生活をしていられたのよ	昔は人って生まれた時から死ぬ時まで同じ生活をしていられたのよ	昔は人って生まれた時から死ぬ時まで同じ生活をしていられたのよ
時代が止まればいいのに	時代が止まればいいのに	時代が止まればいいのに	時代が止まればいいのに
あら	あら	あら	あら
また会ったね	また会ったね	また会ったね	また会ったね
うん	うん	うん	うん
ねえ薬を持ってるんでしょ	ねえ薬を持ってるんでしょ	ねえ薬を持ってるんでしょ	ねえ薬を持ってるんでしょ
毒も持ってる？	毒も持ってる？	毒も持ってる？	毒も持ってる？
持っているわよ	持っているわよ	持っているわよ	持っているわよ
例えばこの風邪薬は一粒飲むと風邪が治る	例えばこの風邪薬は一粒飲むと風邪が治る	例えばこの風邪薬は一粒飲むと風邪が治る	例えばこの風邪薬は一粒飲むと風邪が治る
十粒飲むと死ぬ	十粒飲むと死ぬ	十粒飲むと死ぬ	十粒飲むと死ぬ
それに効き目は人次第	それに効き目は人次第	それに効き目は人次第	それに効き目は人次第
ふーん	ふーん	ふーん	ふーん
なんで毒が欲しいの	なんで毒が欲しいの	なんで毒が欲しいの	なんで毒が欲しいの
眠れる薬とかないの	眠れる薬とかないの	眠れる薬とかないの	眠れる薬とかないの
欲しいの？	欲しいの？	欲しいの？	欲しいの？
私はいらない	私はいらない	私はいらない	私はいらない
......	......	......	......
......	......	......	......
虚無ってなにか知ってる？	虚無ってなにか知ってる？	虚無ってなにか知ってる？	虚無ってなにか知ってる？
虚無？	虚無？	虚無？	虚無？
なにもないことよ	なにもないことよ	なにもないことよ	なにもないことよ
よくわかんない	それはわかるけど	それはわかるけど	それはわかるけど
眠るのとは違うの？	眠るのとは違うの？	眠るのとは違うの？	眠るのとは違うの？
じゃあここはどう？	じゃあここはどう？	じゃあここはどう？	じゃあここはどう？
なにもないけど	なにもないけど	なにもないけど	なにもないけど
そんなことないわ	そんなことないわ	そんなことないわ	そんなことないわ
ここには生き物が蠢いてる	ここには生き物が蠢いてる	ここには生き物が蠢いてる	ここには生き物が蠢いてる
清廉な世界なんて	清廉な世界なんて	清廉な世界なんて	清廉な世界なんて
あなたも私も生きている	あなたも私も生きている	あなたも私も生きている	あなたも私も生きている
でもわたしからっぽだもの	でもわたしからっぽだもの	でもわたしからっぽだもの	でもわたしからっぽだもの
まさか！	まさか！	まさか！	まさか！
そんなことないわ	そんなことないわ	そんなことないわ	そんなことないわ
あなたは愛されているもの	あなたは愛されているもの	あなたは愛されているもの	あなたは愛されているもの
でも	でも	でも	でも
わかんないよ	わかんないよ	でもわたしほんとうは友達いないの	でもわたしほんとうは友達いないの
さみしいの	さみしいの	わたしからっぽなの	わたしからっぽなの
これって虚無？	これって虚無？	生きてても死んでても同じよ	生きてても死んでても同じよ
いいわ	いいわ	いいわ	いいわ
それじゃあ	それじゃあ	それじゃあ	それじゃあ
試供品をあげましょ	試供品をあげましょ	試供品をあげましょ	試供品をあげましょ
死ぬってすごくこわいのよ	死ぬってすごくこわいのよ	死ぬってすごくこわいのよ	死ぬってすごくこわいのよ
死は残酷な旅の始まりなの	死は残酷な旅の始まりなの	死は残酷な旅の始まりなの	死は残酷な旅の始まりなの
もう東洋哲学はいいわ	もう東洋哲学はいいわ	もう東洋哲学はいいわ	もう東洋哲学はいいわ
認知の外側について考えるのは人に任せるわ	認知の外側について考えるのは人に任せるわ	認知の外側について考えるのは人に任せるわ	認知の外側について考えるのは人に任せるわ
私プラグマティストなの	私プラグマティストなの	私プラグマティストなの	私プラグマティストなの
確認しようのない秘封をもとめるなんてナンセンスよ	確認しようのない秘封をもとめるなんてナンセンスよ	確認しようのない秘封をもとめるなんてナンセンスよ	確認しようのない秘封をもとめるなんてナンセンスよ
蓮子、もうやめて	蓮子、もうやめて	蓮子、もうやめて	蓮子、もうやめて
理解に苦しむわ、哲学を語るくせにこいつカントを読んでないのよ	理解に苦しむわ、哲学を語るくせにこいつカントを読んでないのよ	理解に苦しむわ、哲学を語るくせにこいつカントを読んでないのよ	理解に苦しむわ、哲学を語るくせにこいつカントを読んでないのよ
地蔵がしゃべっているのよ	地蔵がしゃべっているのよ	地蔵がしゃべっているのよ	地蔵がしゃべっているのよ
あなたカントにはあったことないでしょ	あなたカントにはあったことないでしょ	あなたカントにはあったことないでしょ	あなたカントにはあったことないでしょ
でも地蔵はほら、いるのよ	でも地蔵はほら、いるのよ	でも地蔵はほら、いるのよ	でも地蔵はほら、いるのよ
でたわね	でたわね	でたわね	でたわね
どうしたの	どうしたの	どうしたの	どうしたの
......	......	......	......
この地蔵が通してくれないのよ	この地蔵が通してくれないのよ	この地蔵が通してくれないのよ	この地蔵が通してくれないのよ
貴方を待ってるみたいよ	貴方を待ってるみたいよ	貴方を待ってるみたいよ	貴方を待ってるみたいよ
えい	えい	えい	えい
ちょっと！	ちょっと！	ちょっと！	ちょっと！
なあに	だって邪魔なんだもの	だって邪魔なんだもの	だって邪魔なんだもの
いえ	いえ	いえ	いえ
その	その	その	その
なんでもないわ	なんでもないわ	なんでもないわ	なんでもないわ
私だってこんなことしないわ	私だってこんなことしないわ	私だってこんなことしないわ	私だってこんなことしないわ
やりかねないわ	やりかねないわ	やりかねないわ	やりかねないわ
なにも起きなければいいんだけれど	なにも起きなければいいんだけれど	なにも起きなければいいんだけれど	なにも起きなければいいんだけれど
わたしわかったのよ！	わたしわかったのよ！	わたしわかったのよ！	わたしわかったのよ！
みんな死ぬの！	みんな死ぬの！	みんな死ぬの！	みんな死ぬの！
でも今じゃないわ	でも今じゃないわ	でも今じゃないわ	でも今じゃないわ
私全部わかったのよ	私全部わかったのよ	私全部わかったのよ	私全部わかったのよ
おうちにかえしてあげる！	おうちにかえしてあげる！	おうちにかえしてあげる！	おうちにかえしてあげる！
なるほど	なるほど	なるほど	なるほど
確かにこの辺りは怪しいわ	確かにこの辺りは怪しいわ	確かにこの辺りは怪しいわ	確かにこの辺りは怪しいわ
境界線が見つかりそう	境界線が見つかりそう	境界線が見つかりそう	境界線が見つかりそう
でもメビウス環的パラドックスの気配もするわ	でもメビウス環的パラドックスの気配もするわ	でもメビウス環的パラドックスの気配もするわ	でもメビウス環的パラドックスの気配もするわ
私にまかせて！	私にまかせて！	私にまかせて！	私にまかせて！
何を探せばいいんだっけ	何を探せばいいんだっけ	何を探せばいいんだっけ	何を探せばいいんだっけ
......	......	......	......
境界を探すのよ	境界を探すのよ	境界を探すのよ	境界を探すのよ
私はそれを見ればそれとわかる	私はそれを見ればそれとわかる	私はそれを見ればそれとわかる	私はそれを見ればそれとわかる
来た時もそこを通じて来たからこのあたりよ	来た時もそこを通じて来たからこのあたりよ	来た時もそこを通じて来たからこのあたりよ	来た時もそこを通じて来たからこのあたりよ
私はその気配を感じ取れる	私はその気配を感じ取れる	私はその気配を感じ取れる	私はその気配を感じ取れる
私は緯度と経度がわかる	私は緯度と経度がわかる	私は緯度と経度がわかる	私は緯度と経度がわかる
けーどって何	井戸は知ってるけど......	井戸は知ってるけど......	井戸は知ってるけど......
......	......	......	......
二酸化ケイ素が土の状態を取るとき――	二酸化ケイ素が土の状態を取るとき――	二酸化ケイ素が土の状態を取るとき――	二酸化ケイ素が土の状態を取るとき――
やめなさいよ	やめなさいよ	やめなさいよ	やめなさいよ
蓮子は今自分がどこにいるかわかるのよ	蓮子は今自分がどこにいるかわかるのよ	蓮子は今自分がどこにいるかわかるのよ	蓮子は今自分がどこにいるかわかるのよ
すごーい	すごいね	本当？	本当？
でも私に任せて	でも私に任せて	それでも行先分からないの？	それでも行先分からないの？
私が二人をお家に返してあげる！	私が二人をお家に返してあげる！	私が二人をお家に返してあげる！	私が二人をお家に返してあげる！
私は専門家だから！	私は専門家だから！	私は専門家だから！	私は専門家だから！
なんの？	なんの？	なんの？	なんの？
ともだち作ったり仲直りさせたり	ともだち作ったり仲直りさせたり	ともだち作ったり仲直りさせたり	ともだち作ったり仲直りさせたり
雪だるまだって名人よ！	雪だるまだって名人よ！	雪だるまだって名人よ！	雪だるまだって名人よ！
クッキーだって作れる	クッキーだって作れる	クッキーだって作れる	クッキーだって作れる
ねえ	ねえ	ねえ	ねえ
一回だけチャンスをあげましょ	一回だけチャンスをあげましょ	一回だけチャンスをあげましょ	一回だけチャンスをあげましょ
あのね、あなた”自分の足で歩く”のよ	あのね、あなた”自分の足で歩く”のよ	あのね、あなた”自分の足で歩く”のよ	あのね、あなた”自分の足で歩く”のよ
それは彼女も一緒でしょ	それは彼女も一緒でしょ	それは彼女も一緒でしょ	それは彼女も一緒でしょ
はやくはじめましょ！	はやくはじめましょ！	はやくはじめましょ！	はやくはじめましょ！
ここかな？	ここなのかしら	きっとここだわ！	きっとここだわ！
ここじゃないみたいね	ここじゃないみたいね	でももっとさーがそ	でももっとさーがそ
ねー	ねー	ねー	ねー
みんな来てー	みんな来てー	みんな来てー	みんな来てー
どうかしら	どうかしら	どうかしら	どうかしら
......	......	......	......
ここに境界があるの？	ここに境界があるの？	ここに境界があるの？	ここに境界があるの？
そう！	そうよ！	そうよ！	そうよ！
ここよく見て！	ここよく見て！	ここよく見て！	ここよく見て！
なんかきらきらしてるでしょ	なんかきらきらしてるでしょ	なんかきらきらしてるでしょ	なんかきらきらしてるでしょ
それに掘ったら土の色が変わるの	それに掘ったら土の色が変わるの	それに掘ったら土の色が変わるの	それに掘ったら土の色が変わるの
これ境界？	これ境界？	これ境界？	これ境界？
......	......	......	......
これ正解でしょ！	これ正解でしょ！	これ正解でしょ！	これ正解でしょ！
......	......	......	......
そうよ！	そうよ！	そうよ！	そうよ！
おめでとう	おめでとう	おめでとう	おめでとう
頑張ったわね	頑張ったわね	頑張ったわね	頑張ったわね
ちょっと	ちょっと	ちょっと	ちょっと
いいのよ	いいのよ	いいのよ	いいのよ
でもこれはちっちゃすぎて通れないから私は私のを探すわ	でもこれはちっちゃすぎて通れないから私は私のを探すわ	でもこれはちっちゃすぎて通れないから私は私のを探すわ	でもこれはちっちゃすぎて通れないから私は私のを探すわ
手伝おうか？	手伝おうか？	手伝おうか？	手伝おうか？
ううん大丈夫よ	ううん大丈夫よ	ううん大丈夫よ	ううん大丈夫よ
行きましょ	行きましょ	行きましょ	行きましょ
ここだわ。空間の重なりの境界線があるわ	ここだわ。空間の重なりの境界線があるわ	ここだわ。空間の重なりの境界線があるわ	ここだわ。空間の重なりの境界線があるわ
どこ	どこ	どこ	どこ
そこよ	そこよ	そこよ	そこよ
あなたには見えないわ	あなたには見えないわ	あなたには見えないわ	あなたには見えないわ
私が見つけたのより大きいのに見えないの	私が見つけたのより大きいのに見えないの	私が見つけたのより大きいのに見えないの	私が見つけたのより大きいのに見えないの
大きい力ほど目には見えないものなのよ	大きい力ほど目には見えないものなのよ	大きい力ほど目には見えないものなのよ	大きい力ほど目には見えないものなのよ
そうかなー	そうかなー	ほんとう？	ほんとう？
じゃあね	じゃあね	じゃあね	じゃあね
行っちゃうの	行っちゃうの	行っちゃうの	行っちゃうの
うん	うん	うん	うん
なんで	なんで	なんで	なんで
なんでって	なんでって	なんでって	なんでって
私たちは住む世界が違うのよ	私たちは住む世界が違うのよ	私たちは住む世界が違うのよ	私たちは住む世界が違うのよ
お手伝いしてくれてありがとう	お手伝いしてくれてありがとう	お手伝いしてくれてありがとう	お手伝いしてくれてありがとう
行かなきゃ	行かなきゃ	行かなきゃ	行かなきゃ
また会えるんだよね	また会えるんだよね	また会えるんだよね	また会えるんだよね
いいえ	いいえ	いいえ	いいえ
行くわよ	行くわよ	行くわよ	行くわよ
さよなら	さよなら	さよなら	さよなら
あれー......	あれー......	あれー......	あれー......
ほんとにいなくなっちゃった	ほんとにいなくなっちゃった	ほんとにいなくなっちゃった	ほんとにいなくなっちゃった
.....	.....	.....	.....
行かなきゃ	行かなきゃ	行かなきゃ	行かなきゃ
どこだっけ	どこだっけ	どこだっけ	どこだっけ
つかれた	.........	.........	.........
かえりたい	かえりたい	かえりたい	かえりたい
でもどっちだろ	でもどっちだろ	でもいや	でもいや
うー	うう	うう	うう
.....	.....	.....	.....
.....	.....	.....	.....
.....	.....	.....	.....
.....	.....	.....	.....
.....	.....	.....	.....
.....	.....	.....	.....
いく	いく	いく	いく
こいし！（画面外からふきだしのみ）	こいし！（画面外からふきだしのみ）	こいし！（画面外からふきだしのみ）	こいし！（画面外からふきだしのみ）
どこなの！	どこなの！	どこなの！	どこなの！
ここかな？	ここなのかしら	きっとここだわ！	きっとここだわ！
ここじゃないみたいね	ここじゃないみたいね	でももっとさーがそ	でももっとさーがそ
ねー	ねー	ねー	ねー
みんな来てー	みんな来てー	みんな来てー	みんな来てー
見つかったのかしら？	見つかったのかしら？	見つかったのかしら？	見つかったのかしら？
どうかしら	どうかしら	どうかしら	どうかしら
見つかったのかしら？	見つかったのかしら？	見つかったのかしら？	見つかったのかしら？
ここに境界があるの？	ここに境界があるの？	ここに境界があるの？	ここに境界があるの？
そう！	そうよ！	そうよ！	そうよ！
どう？	どう？	どう？	どう？
あなたどうしてここがわかったの？	あなたどうしてここがわかったの？	あなたどうしてここがわかったの？	あなたどうしてここがわかったの？
えー	えー	達人だからよ！	達人だからよ！
わかったから	わかったから	ンフフ	ンフフ
やっぱり私とは違うのね	やっぱり私とは違うのね	やっぱり私とは違うのね	やっぱり私とは違うのね
なによ	なによ	なによ	なによ
私たちに失礼よ	私たちに失礼よ	私たちに失礼よ	私たちに失礼よ
いいわ	いいわ	いいわ	いいわ
行きましょ	行きましょ	行きましょ	行きましょ
そうね	そうね	そうね	そうね
こいしちゃん、ありがとうね	こいしちゃん、ありがとうね	こいしちゃん、ありがとうね	こいしちゃん、ありがとうね
もういくの	もういくの	もういくの	もういくの
うん	うん	うん	うん
やらなくちゃいけないことがあるから	やらなくちゃいけないことがあるから	やらなくちゃいけないことがあるから	やらなくちゃいけないことがあるから
えー	えー	ほかにも面白いのあるのよ	ほかにも面白いのあるのよ
まだいいでしょ	まだいいでしょ	お絵かき見せてあげるから	お絵かき見せてあげるから
ごめんね	ごめんね	ごめんね	ごめんね
またくるよ	またくるよ	またくるよ	またくるよ
またっていつ	またっていつ	またっていつ	またっていつ
あした？	あした？	いつ？	いつ？
あしたの日の時のあした？	あしたの日の時のあした？	いつくるの	いつくるの
そうね	そうね	そうね	そうね
いつか	いつか	いつか	いつか
ずーっとずーっと長生きしたら	ずーっとずーっと長生きしたら	ずーっとずーっと長生きしたら	ずーっとずーっと長生きしたら
また会えるんだよね	また会えるんだよね	また会えるんだよね	また会えるんだよね
いいえ	いいえ	いいえ	いいえ
行くわよ	行くわよ	行くわよ	行くわよ
さよなら	さよなら	さよなら	さよなら
あれー......	あれー......	あれー......	あれー......
ほんとにいなくなっちゃった	ほんとにいなくなっちゃった	ほんとにいなくなっちゃった	ほんとにいなくなっちゃった
.....	.....	.....	.....
行かなきゃ	行かなきゃ	行かなきゃ	行かなきゃ
どこだっけ	どこだっけ	どこだっけ	どこだっけ
まずはあっちへ行ってみましょ	まずはあっちへ行ってみましょ	まずはあっちへ行ってみましょ	まずはあっちへ行ってみましょ
この辺りはメビウス環がねじれているわ	この辺りはメビウス環がねじれているわ	この辺りはメビウス環がねじれているわ	この辺りはメビウス環がねじれているわ
わからなかったらカンでもいいのよ	わからなかったらカンでもいいのよ	わからなかったらカンでもいいのよ	わからなかったらカンでもいいのよ
目的地はここから東の方角みたいね	目的地はここから東の方角みたいね	目的地はここから東の方角みたいね	目的地はここから東の方角みたいね
ここに境界はないわ	ここに境界はないわ	ここに境界はないわ	ここに境界はないわ
境界は南の方角よ！	境界は南の方角よ！	境界は南の方角よ！	境界は南の方角よ！
北の方角は向こうよ	北の方角は向こうよ	北の方角は向こうよ	北の方角は向こうよ
キャンプ地はあっちよ	キャンプ地はあっちよ	キャンプ地はあっちよ	キャンプ地はあっちよ
キャンプ地はあっちよ	キャンプ地はあっちよ	キャンプ地はあっちよ	キャンプ地はあっちよ
ここをキャンプ地としましょ	ここをキャンプ地としましょ	ここをキャンプ地としましょ	ここをキャンプ地としましょ
言っとくがあっちには本当に何もないぞ	言っとくがあっちには本当に何もないぞ	言っとくがあっちには本当に何もないぞ	言っとくがあっちには本当に何もないぞ
メリーは東洋哲学をなにかはき違えているみたいね	メリーは東洋哲学をなにかはき違えているみたいね	メリーは東洋哲学をなにかはき違えているみたいね	メリーは東洋哲学をなにかはき違えているみたいね
無なんて無意味よ	無なんて無意味よ	無なんて無意味よ	無なんて無意味よ
なんにせよあのちんちくりんの化け物は本当にヤバいぞ	なんにせよあのちんちくりんの化け物は本当にヤバいぞ	なんにせよあのちんちくりんの化け物は本当にヤバいぞ	なんにせよあのちんちくりんの化け物は本当にヤバいぞ
お前には見えてないみたいだけどな	お前には見えてないみたいだけどな	お前には見えてないみたいだけどな	お前には見えてないみたいだけどな
もしあの娘を助けたかったらお前も空っぽの器に手を突っ込まなくちゃあいけないね	もしあの娘を助けたかったらお前も空っぽの器に手を突っ込まなくちゃあいけないね	もしあの娘を助けたかったらお前も空っぽの器に手を突っ込まなくちゃあいけないね	もしあの娘を助けたかったらお前も空っぽの器に手を突っ込まなくちゃあいけないね
おっかないなあ	おっかないなあ	おっかないなあ	おっかないなあ
妖怪は本当にいたのか	妖怪は本当にいたのか	妖怪は本当にいたのか	妖怪は本当にいたのか
......まあな	......まあな	......まあな	......まあな
............	............	............	............
こんにちは	こんにちは	こんにちは	こんにちは
おいまたお前か！	おいまたお前か！	おいまたお前か！	おいまたお前か！
うっとおしいなあ	うっとおしいなあ	うっとおしいなあ	うっとおしいなあ
探し物してるの	探し物してるの	探し物してるの	探し物してるの
お手伝いして！	お手伝いして！	お手伝いして！	お手伝いして！
なんで	なんで	なんで	なんで
なんで？	なんで？	なんで？	なんで？
手伝わないの？	手伝わないの？	手伝わないの？	手伝わないの？
なんで手伝わなきゃならないのさ	なんで手伝わなきゃならないのさ	なんで手伝わなきゃならないのさ	なんで手伝わなきゃならないのさ
手伝うのが友達じゃないの......	手伝うのが友達じゃないの......	手伝うのが友達じゃないの......	手伝うのが友達じゃないの......
お前友達じゃないだろ	お前友達じゃないだろ	お前友達じゃないだろ	お前友達じゃないだろ
そうなの？	そうなの？	そうなの？	そうなの？
ほら、とっとと失せやがれ	ほら、とっとと失せやがれ	ほら、とっとと失せやがれ	ほら、とっとと失せやがれ
おやすみ	おやすみ	おやすみ	おやすみ
こんどはうまくいきますように	こんどはうまくいきますように	こんどはうまくいきますように	こんどはうまくいきますように
よく寝た！	よく寝た！	よく寝た！	よく寝た！
もう一杯寝た！	もう一杯寝た！	もう寝ていられないわ	もう寝ていられないわ
あけたくない	あけたくない	ここおっきな蜘蛛がいるのよ！	ここおっきな蜘蛛がいるのよ！
この日記	この日記	この日記	この日記
ページなくなっちゃってる！	ページなくなっちゃってる！	ページなくなっちゃってる！	ページなくなっちゃってる！
だれがとったの！？	だれがとったの！？	だれがとったの！？	だれがとったの！？
あはは	あはは	あはは	あはは
もういらないもーん	もういらないもーん	今は緑色が欲しい！	今は緑色が欲しい！
また来てる！	また来てる！	あの子なんなんだろう	あの子なんなんだろう
誰？	誰？	変な子！	変な子！
じょーん	じょーん	ジョンまだ帰ってこない	ジョンまだ帰ってこない
出てこないなー	出てこないなー	出てこないなー	出てこないなー
まっくろ！	まっくろ！	まっくら！	まっくら！
死んだ人を運ぶの	死んだ人を運ぶの	死んだ人を運ぶの	死んだ人を運ぶの
怪我なんてしてないもーん	怪我なんてしてないもーん	メリーと蓮子大丈夫かな	メリーと蓮子大丈夫かな
わー	わー	わー	わー
なつかしい	なつかしい	ちょっとなつかしい	ちょっとなつかしい
ぐわあ、がー、ぐわあ	ぐわあ、がー、ぐわあ	ぐわあ、がー、ぐわあ	ぐわあ、がー、ぐわあ
なんだろ！	なんだろ！	なにかしら	なにかしら
へんなこえ！	へんなこえ！	いってみましょ	いってみましょ
があ、があ	があ、があ	があ、があ	があ、があ
ぐわあ	ぐわあ	ぐわあ	ぐわあ
こっち！	こっち！	こっちね！	こっちね！
びょーきなのかな	びょーきなのかな	苦しそうだわ	苦しそうだわ
まあ！	まあ！	まあ！	まあ！
あなたどうしたの	あなたどうしたの	あなたどうしたの	あなたどうしたの
があ、があ	があ、があ	があ、があ	があ、があ
があ！	があ！	があ！	があ！
があ、ぐわあ！	があ、ぐわあ！	があ、ぐわあ！	があ、ぐわあ！
あはは、へんなの	あはは、へんなの	これじゃあさっぱりね	これじゃあさっぱりね
ねえ、助けて！	ねえ、助けて！	ねえ、助けて！	ねえ、助けて！
まあ！	まあ！	まあ！	まあ！
あなたどうしたの！	あなたどうしたの！	あなたどうしたの！	あなたどうしたの！
つかまっちゃったのよう！	つかまっちゃったのよう！	つかまっちゃったのよう！	つかまっちゃったのよう！
だれに？	だれに？	どうして？	どうして？
ご主人様に......	ご主人様に......	ご主人様に......	ご主人様に......
危ないからって	危ないからって	危ないからって	危ないからって
みんなは遊んでるのにずるい！	みんなは遊んでるのにずるい！	みんなは遊んでるのにずるい！	みんなは遊んでるのにずるい！
なんでわたしだけお留守番なの？	なんでわたしだけお留守番なの？	なんでわたしだけお留守番なの？	なんでわたしだけお留守番なの？
.....	.....	.....	.....
かわいそう	かわいそう	かわいそう	かわいそう
助けてあげるわ！	助けてあげるわ！	助けてあげるわ！	助けてあげるわ！
ほんとう！？	ほんとう！？	ほんとう！？	ほんとう！？
うれしいなあ！	うれしいなあ！	うれしいなあ！	うれしいなあ！
檻の鍵はご主人様が持ってるの	檻の鍵はご主人様が持ってるの	檻の鍵はご主人様が持ってるの	檻の鍵はご主人様が持ってるの
ぬすんできてちょうだい！	ぬすんできてちょうだい！	ぬすんできてちょうだい！	ぬすんできてちょうだい！
わかったわ	わかったわ	わかったわ	わかったわ
でもどこにいるかしら	でもどこにいるかしら	でもどこにいるかしら	でもどこにいるかしら
ご主人様の部屋は奥のほう	ご主人様の部屋は奥のほう	ご主人様の部屋は奥のほう	ご主人様の部屋は奥のほう
そっか	そっか	そっか	そっか
じゃあ行ってくるね！	じゃあ行ってくるね！	じゃあ行ってくるね！	じゃあ行ってくるね！
わんわん！	わんわん！	わんわん！	わんわん！
があっがあっ	があっがあっ	があっがあっ	があっがあっ
ぶるるぶるる	ぶるるぶるる	ぶるるぶるる	ぶるるぶるる
いいいいいっ	いいいいいっ	いいいいいっ	いいいいいっ
うぴゃーっうぴゃーっ	うぴゃーっうぴゃーっ	うぴゃーっうぴゃーっ	うぴゃーっうぴゃーっ
ぐるるるるる	ぐるるるるる	ぐるるるるる	ぐるるるるる
ぴいーっぴいーっ	ぴいーっぴいーっ	ぴいーっぴいーっ	ぴいーっぴいーっ
チチチチイ	チチチチイ	チチチチイ	チチチチイ
んなぁお	んなぁお	んなぁお	んなぁお
うるさい！	うるさい！	うるさい！	うるさい！
動物の声だわ	動物の声だわ	動物の声だわ	動物の声だわ
楽しそう！	楽しそう！	楽しそう！	楽しそう！
があー	があー	があー	があー
まずあの子を助けなきゃ	まずあの子を助けなきゃ	まずあの子を助けなきゃ	まずあの子を助けなきゃ
あの部屋へ行かなきゃ	あの部屋へ行かなきゃ	奥だったわね	奥だったわね
みゃあぉう	みゃあぉう	みゃあぉう	みゃあぉう
うにゃーっ	うにゃーっ	うにゃーっ	うにゃーっ
ねこちゃん！	ねこちゃん！	猫だ！	猫だ！
にゃんにゃ	にゃんにゃ	にゃんにゃ	にゃんにゃ
んみゃ	んみゃ	んみゃ	んみゃ
あら！	あら！	あら！	あら！
こいし様おひさしぶりですね	こいし様おひさしぶりですね	こいし様おひさしぶりですね	こいし様おひさしぶりですね
えっ	えっ	えっ、うん	えっ、うん
私のこと知ってるの	私のこと知ってるの	何してるの	何してるの
あたりまえじゃないですか	あたりまえじゃないですか	あたりまえじゃないですか	あたりまえじゃないですか
おそうじちゅうなんです	おそうじちゅうなんです	おそうじちゅうなんです	おそうじちゅうなんです
そうなんだ	そうなんだ	そうなんだ	そうなんだ
ご主人様に御用ですか？	ご主人様に御用ですか？	ご主人様に御用ですか？	ご主人様に御用ですか？
あいにくお出かけされていますが	あいにくお出かけされていますが	あいにくお出かけされていますが	あいにくお出かけされていますが
べつに	べつに	ううんいいの	ううんいいの
ねえ鍵知ってる？	ねえ鍵知ってる？	ねえ鍵知ってる？	ねえ鍵知ってる？
なんの鍵ですか？	なんの鍵ですか？	なんの鍵ですか？	なんの鍵ですか？
屋敷の鍵はみんなご主人様が持っているはずですケド	屋敷の鍵はみんなご主人様が持っているはずですケド	屋敷の鍵はみんなご主人様が持っているはずですケド	屋敷の鍵はみんなご主人様が持っているはずですケド
なーん	なーん	なーん	なーん
日記！	日記！	日記だわ！	日記だわ！
これお姉ちゃんの	これお姉ちゃんの	これお姉ちゃんの	これお姉ちゃんの
......	......	......	......
死んだんじゃなかったっけ......	死んだんじゃなかったっけ......	死んだんじゃなかったっけ......	死んだんじゃなかったっけ......
ピッ	ピッ	ピッ	ピッ
......	......	......	......
ピピッ	ピピッ	ピピッ	ピピッ
ピィ	ピィ	ピィ	ピィ
......	......	......	......
どうしたの	どうしたの	どうしたの	どうしたの
......	......	......	......
あなただあれ	あなただあれ	あなただあれ	あなただあれ
こいし	こいし	こいしです	こいしです
......	......	......	......
あなたは？	あなたは？	あなたは？	あなたは？
ハリネズミですけども......	ハリネズミですけども......	ハリネズミですけども......	ハリネズミですけども......
そっか	そっか	そっか......	そっか......
そっとしといてください......	そっとしといてください......	そっとしといてください......	そっとしといてください......
ごめん	ごめん	ごめん	ごめん
キュウキュウ	キュウキュウ	キュウキュウ	キュウキュウ
ココココココココ	ココココココココ	ココココココココ	ココココココココ
こわい	こわい	ちょっとこわいな	ちょっとこわいな
すごい顔だね	すごい顔だね	すごい顔だね	すごい顔だね
なんだお前は	なんだお前は	なんだお前は	なんだお前は
失礼だな	失礼だな	失礼だな	失礼だな
......	......	ごめん	ごめん
なんで怒ってるの	なんで怒ってるの	何かあったの	何かあったの
いや......	いや......	いや......	いや......
別に......	別に......	別に......	別に......
おこってないのにそんな顔なんですか	おこってないのにそんな顔なんですか	おこってないのにそんな顔なんですか	おこってないのにそんな顔なんですか
お前失礼だな	お前失礼だな	お前失礼だな	お前失礼だな
丁寧に聞いても駄目だぞ	丁寧に聞いても駄目だぞ	丁寧に聞いても駄目だぞ	丁寧に聞いても駄目だぞ
はい	はい	ごめんなさい	ごめんなさい
キィーッ	キィーッ	キィーッ	キィーッ
ピャー	ピャー	ピャー	ピャー
うわーっ	うわーっ	うわーっ	うわーっ
うるさい！	うるさい！	うるさい！	うるさい！
ピャー	ピャー	ピャー	ピャー
ヒヒヒ	ヒヒヒ	ヒヒヒ	ヒヒヒ
ヒヒヒ	ヒヒヒ	ヒヒヒ	ヒヒヒ
うるさいなあ	うるさいわねえ	うるさいわねえ	うるさいわねえ
ああー？	ああー？	ああー？	ああー？
なんだおまえ	なんだおまえ	なんだおまえ	なんだおまえ
こいし	こいし	わたしはこいし	わたしはこいし
へえーっ小石ね	へえーっ小石ね	へえーっ小石ね	へえーっ小石ね
名前通りのコロコロしたやつだぜ	名前通りのコロコロしたやつだぜ	名前通りのコロコロしたやつだぜ	名前通りのコロコロしたやつだぜ
......	......	失礼ね	失礼ね
ぎいーっぎいーっ	ぎいーっぎいーっ	ぎいーっぎいーっ	ぎいーっぎいーっ
ケケケケ	ケケケケ	ケケケケ	ケケケケ
ほんとうにうるさい！	ほんとうにうるさい！	ほんとうにうるさい！	ほんとうにうるさい！
はしご！	はしご！	これはしごね！	これはしごね！
もらっちゃえ	もらっちゃえ	もらっちゃえ	もらっちゃえ
イッ	イッ	イッ	イッ
イーッ	イーッ	イーッ	イーッ
イッイッイッ	イッイッイッ	イッイッイッ	イッイッイッ
......	......	こわい	こわい
やめとこ	やめとこ	やめとこう	やめとこう
はしご！	はしご！	はしごだわ！	はしごだわ！
アーッ	アーッ	アーッ	アーッ
だめなんだぞだめなんだぞ	だめなんだぞだめなんだぞ	だめなんだぞだめなんだぞ	だめなんだぞだめなんだぞ
さとり様がダメって言ってたのに	さとり様がダメって言ってたのに	さとり様がダメって言ってたのに	さとり様がダメって言ってたのに
いーけないんだ	いーけないんだ	いーけないんだ	いーけないんだ
いけないんだ	いけないんだ	いけないんだ	いけないんだ
さとり様に言っちゃお	さとり様に言っちゃお	さとり様に言っちゃお	さとり様に言っちゃお
ケケケ	ケケケ	ケケケ	ケケケ
......	......	うるさいな	うるさいな
はい	はい	じゃあいい	じゃあいい
ぅぅぅ	ぅぅぅ	ぅぅぅ	ぅぅぅ
わん	わん	わん	わん
......こわくないけどね	......こわくないけどね	かわいー	かわいー
ぅわん	ぅわん	ぅわん	ぅわん
はフはフ	はフはフ	はフはフ	はフはフ
かわいー	かわいー	かわいー	かわいー
こまったわ	こまったわ	こまったわ	こまったわ
なにがこまったの	なにがこまったの	どうしたの	どうしたの
はしごが無いのよ	はしごが無いのよ	はしごが無いのよ	はしごが無いのよ
ほんとうはここにかけてあるのに	ほんとうはここにかけてあるのに	ほんとうはここにかけてあるのに	ほんとうはここにかけてあるのに
ふーん	ふーん	ふーん	ふーん
なんで？	なんで？	上にはなにがあるの？	上にはなにがあるの？
上に行かなきゃいけないのよー	上に行かなきゃいけないのよー	上に行かなきゃいけないのよー	上に行かなきゃいけないのよー
ふーん	ふーん	わたしにまかせて	わたしにまかせて
これいる	これいる	やっぱりこれがいるわ	やっぱりこれがいるわ
あー！！！！	あー！！！！	あー！！！！	あー！！！！
アーッ	アーッ	アーッ	アーッ
だめなんだぞだめなんだぞ	だめなんだぞだめなんだぞ	だめなんだぞだめなんだぞ	だめなんだぞだめなんだぞ
さとり様がダメって言ってたのに	さとり様がダメって言ってたのに	さとり様がダメって言ってたのに	さとり様がダメって言ってたのに
いーけないんだ	いーけないんだ	いーけないんだ	いーけないんだ
いけないんだ	いけないんだ	いけないんだ	いけないんだ
さとり様に言っちゃお	さとり様に言っちゃお	さとり様に言っちゃお	さとり様に言っちゃお
ケケケ	ケケケ	ケケケ	ケケケ
......	......	......	......
ふんだ！	ふんだ！	あらそう	あらそう
お姉ちゃんはもういないもん！	お姉ちゃんはもういないもん！	もうそんなのいないもん	もうそんなのいないもん
あ......	あ......	あ......	あ......
そう......	そう......	そう......	そう......
これいる	これいる	やっぱりこれがいるわ	やっぱりこれがいるわ
イッ	イッ	イッ	イッ
イーッ	イーッ	イーッ	イーッ
イッイッイッ	イッイッイッ	イッイッイッ	イッイッイッ
......	......	うるさい！	うるさい！
イーッ......	イーッ......	イーッ......	イーッ......
オイラのはしご......	オイラのはしご......	オイラのはしご......	オイラのはしご......
......	......	ごめんね	ごめんね
うん	うん	ちょっとかしてね	ちょっとかしてね
イーッ......	イーッ......	イーッ......	イーッ......
犬ちゃん	犬ちゃん	犬ちゃん	犬ちゃん
犬って何よ	犬って何よ	犬って何よ	犬って何よ
はしご！	はしご！	ハシゴ持ってきたのよ	ハシゴ持ってきたのよ
ほんと？	ほんと？	ほんと？	ほんと？
ほんとだ！	ほんとだ！	ほんとだ！	ほんとだ！
これでよし！	これでよし！	これでよし！	これでよし！
助かったわ	助かったわ	助かったわ	助かったわ
ありがとう、こいしちゃん	ありがとう、こいしちゃん	ありがとう、こいしちゃん	ありがとう、こいしちゃん
あれー	あれー	あら	あら
名前知ってるの	名前知ってるの	名前知ってるの	名前知ってるの
だれ	だれ	あなた名前なんていうの	あなた名前なんていうの
ジョン	ジョン	ジョン	ジョン
！	！	！	！
じゃあわたし上に行くわね！	じゃあわたし上に行くわね！	じゃあわたし上に行くわね！	じゃあわたし上に行くわね！
ついてこないでね！	ついてこないでね！	ついてこないでね！	ついてこないでね！
なんで	なんで	どうして？	どうして？
......	......	......	......
故あって......	故あって......	故あって......	故あって......
なにそれ	なにそれ	いじわるね	いじわるね
ごめんね	ごめんね	ごめんね	ごめんね
これ早く隠して	これ早く隠して	これ早く隠して	これ早く隠して
わかったわ	わかったわ	わかったわ	わかったわ
お願いね	お願いね	お願いね	お願いね
わふ	わふ	わふ	わふ
イイーン	イイーン	イイーン	イイーン
わふぅ	わふぅ	わふぅ	わふぅ
わふ	わふ	わふ	わふ
イイーン	イイーン	イイーン	イイーン
わふぅ	わふぅ	わふぅ	わふぅ
なにしてるの	なにしてるの	なにしてるの	なにしてるの
なにも	なにも	なにも	なにも
なに	なに	なに	なに
なんで教えてくれないの	なんで教えてくれないの	なんで教えてくれないの	なんで教えてくれないの
さっき何渡してたの	さっき何渡してたの	さっき何渡してたの	さっき何渡してたの
......	......	......	......
言えません！	言えません！	言えません！	言えません！
ご主人様にとめられているから	ご主人様にとめられているから	ご主人様にとめられているから	ご主人様にとめられているから
私だってご主人様でしょ	私だってご主人様でしょ	ふぅん	ふぅん
......	......	......	......
......	......	......	......
......	......	......	......
ぷごぅ	ぷごぅ	ぷごぅ	ぷごぅ
......	......	......	......
......	......	......	......
ぜんぜん鳴かない！	ぜんぜん鳴かない！	ぜんぜん鳴かない！	ぜんぜん鳴かない！
......	......	......	......
......	......	......	......
ぜんぜん喋んない！	ぜんぜん喋んない！	ぜんぜん喋んない！	ぜんぜん喋んない！
何よ	何よ	何よ	何よ
なんだ	なんだ	喋れるじゃない	喋れるじゃない
強い生き物は鳴かないのよ	強い生き物は鳴かないのよ	強い生き物は鳴かないのよ	強い生き物は鳴かないのよ
かっこいい	かっこいい	かっこいいね	かっこいいね
ふふん	ふふん	ふふん	ふふん
私みたいに女の武器を持てば――	私みたいに女の武器を持てば――	私みたいに女の武器を持てば――	私みたいに女の武器を持てば――
誰だっていうことを聞くわ	誰だっていうことを聞くわ	誰だっていうことを聞くわ	誰だっていうことを聞くわ
ほんと！？	ほんと！？	そうなの！？	そうなの！？
武器かー	武器かー	武器を探さなくちゃ	武器を探さなくちゃ
あ！	あ！	まあ！	まあ！
逃げたわね	逃げたわね	逃げたわね	逃げたわね
あぶないわ	あぶないわ	だれが外したの？	だれが外したの？
これ！	これ！	これがいいわ	これがいいわ
すてき	すてき	すてき	すてき
強そうね！	強そうね！	強そうね！	強そうね！
ぶぅおー	ぶぅおー	ぶぅおー	ぶぅおー
ぐもー	ぐもー	ぐもー	ぐもー
怪獣がいるわ	怪獣がいるわ	怪獣がいるわ	怪獣がいるわ
ぶおっぶおっ	ぶおっぶおっ	ぶおっぶおっ	ぶおっぶおっ
ごぉー	ごぉー	ごぉー	ごぉー
あはは	あはは	えへへ	えへへ
へんなかおー	へんなかおー	へんなかおー	へんなかおー
へんなかおー	へんなかおー	へんなかおー	へんなかおー
なんだよー	なんだよー	なんだよー	なんだよー
なんなんだよー	なんなんだよー	なんなんだよー	なんなんだよー
なにしてんだよー	なにしてんだよー	なにしてんだよー	なにしてんだよー
なにしてんだっけ	なにしてんだっけ	なにしてんだっけ	なにしてんだっけ
ああそうだ	ああそうだ	ああそうだ	ああそうだ
鍵探してるの	鍵探してるの	鍵探してるの	鍵探してるの
何の鍵なんですか？	何の鍵なんですか？	何の鍵なんですか？	何の鍵なんですか？
鳥ちゃんの	鳥ちゃんの	鳥ちゃんの	鳥ちゃんの
鳥ちゃん	鳥ちゃん	鳥ちゃん	鳥ちゃん
鳥ちゃん......	鳥ちゃん......	鳥ちゃん......	鳥ちゃん......
烏ちゃんのこと？	烏ちゃんのこと？	烏ちゃんのこと？	烏ちゃんのこと？
たぶん	たぶん	たぶん	たぶん
それでね	それでね	それがね	それがね
うん	うん	うん	うん
そのカギがいるんだけど	そのカギがいるんだけど	そのカギがいるんだけど	そのカギがいるんだけど
えっ	えっ	えっ	えっ
あの子を出すの？	あの子を出すの？	あの子を出すの？	あの子を出すの？
それはだめだよー	それはだめだよー	それはだめだよー	それはだめだよー
まだ危ないよ	まだ危ないよ	まだ危ないよ	まだ危ないよ
なんで	なんで	なんで	なんで
なんでって	なんでって	なんでって	なんでって
怪我しちゃうよ	怪我しちゃうよ	怪我しちゃうよ	怪我しちゃうよ
やだ！	やだ！	なにそれ	なにそれ
1人ぼっちで	1人ぼっちで	1人ぼっちで	1人ぼっちで
閉じ込められて	閉じ込められて	閉じ込められて	閉じ込められて
かわいそうじゃないの	かわいそうじゃないの	かわいそうじゃないの	かわいそうじゃないの
そうでしょ	そうでしょ	そうでしょ	そうでしょ
そうだけど	そうだけど	そうだけど	そうだけど
そうだけど......	そうだけど......	そうだけど......	そうだけど......
言って！	言って！	言いなさい！	言いなさい！
鍵はどこなの	鍵はどこなの	鍵はどこなの	鍵はどこなの
でも......	でも......	でも......	でも......
だめって言ってたから	だめって言ってたから	だめって言ってたから	だめって言ってたから
分からない子ね！	分からない子ね！	分からない子ね！	分からない子ね！
おしおきよ！	おしおきよ！	おしおきよ！	おしおきよ！
ぶぅお！	ぶぅお！	ぶぅお！	ぶぅお！
わかった！わかりました！	わかった！わかりました！	わかった！わかりました！	わかった！わかりました！
鍵は犬が持ってた！	鍵は犬が持ってた！	鍵は犬が持ってた！	鍵は犬が持ってた！
犬ちゃんが？	犬ちゃんが？	犬ちゃんが？	犬ちゃんが？
そう	そう	そう	そう
わかった	わかった	わかったわ	わかったわ
ありがとう	ありがとう	いいこね！	いいこね！
行かなきゃ	行かなきゃ	さっき渡したのね	さっき渡したのね
武器ってすごいわ！	武器ってすごいわ！	武器ってすごいわ！	武器ってすごいわ！
みっけ！	みっけ！	みっけ！	みっけ！
ぶぃっ	ぶぃっ	ぶぃっ	ぶぃっ
ひひン	ひひン	ひひン	ひひン
あはは怖がってる	あはは怖がってる	あはは怖がってる	あはは怖がってる
なんなの	なんなの	なんなの	なんなの
......	......	......	......
......	......	......	......
うう......	うう......	うう......	うう......
......	......	......	......
言っちゃダメって言われてるの	言っちゃダメって言われてるの	言っちゃダメって言われてるの	言っちゃダメって言われてるの
誰に	誰に	誰に	誰に
ご主人様に......	ご主人様に......	ご主人様に......	ご主人様に......
もう死んだもン	もう死んだもン	もう死んだもン	もう死んだもン
だから気にしなくてもいいんだよ	だから気にしなくてもいいんだよ	だから気にしなくてもいいんだよ	だから気にしなくてもいいんだよ
......	......	......	......
いい子だから教えて？	いい子だから教えて？	いい子だから教えて？	いい子だから教えて？
......	......	......	......
地下に埋めました	地下に埋めました	地下に埋めました	地下に埋めました
いいこね	いいこね	いいこね	いいこね
......	......	......	......
ご褒美にクッキー焼いてあげる	ご褒美にクッキー焼いてあげる	ご褒美にクッキー焼いてあげる	ご褒美にクッキー焼いてあげる
ピぃーっ	ピぃーっ	ピぃーっ	ピぃーっ
あはは！	あはは！	あはは！	あはは！
おめめがヘン！	おめめがヘン！	おめめがヘン！	おめめがヘン！
きーきー	きーきー	きーきー	きーきー
あはは、へんなかおー	あはは、へんなかおー	あはは、へんなかおー	あはは、へんなかおー
あなたは？	あなたは？	あなたは？	あなたは？
もぐら	もぐら	もぐら	もぐら
もぐらって初めて見た	もぐらって初めて見た	もぐらって初めて見た	もぐらって初めて見た
こっちもさ	こっちもさ	こっちもさ	こっちもさ
聞いていたよりひどい	聞いていたよりひどい	聞いていたよりひどい	聞いていたよりひどい
何が？	何が？	何が？	何が？
早くいけって	早くいけって	早くいけって	早くいけって
疲れてるんだ	疲れてるんだ	疲れてるんだ	疲れてるんだ
あ、うん	あ、うん	あ、うん	あ、うん
おうまさんは	おうまさんは	おうまさんは	おうまさんは
あっちへ行って	あっちへ行って	あっちへ行って	あっちへ行って
そっちへ走ってった	そっちへ走ってった	そっちへ走ってった	そっちへ走ってった
そっか	そっか	そっか	そっか
ありがとう	ありがとう	ありがとう	ありがとう
とっとと終わらせてくれ	とっとと終わらせてくれ	とっとと終わらせてくれ	とっとと終わらせてくれ
ねえねえ	ねえねえ	ねえねえ	ねえねえ
スピーッ	スピーッ	スピーッ	スピーッ
寝ちゃった	寝ちゃった	寝ちゃった	寝ちゃった
あったーっ	あったーっ	あったーっ	あったーっ
これで友達を助けられるわ	これで友達を助けられるわ	これで友達を助けられるわ	これで友達を助けられるわ
なにかしらこれ	なにかしらこれ	なにかしらこれ	なにかしらこれ
あっちからきたけど	あっちからきたけど	誰なの？	誰なの？
いまはそれどころじゃないわ	いまはそれどころじゃないわ	いまはそれどころじゃないわ	いまはそれどころじゃないわ
......	......	......	......
......	......	......	......
......	......	......	......
くくくくく	くくくくく	くくくくく	くくくくく
キュ	キュ	キュ	キュ
ちょっと！	ちょっと！	ちょっと！	ちょっと！
目玉を転がしたのあなた？	目玉を転がしたのあなた？	目玉を転がしたのあなた？	目玉を転がしたのあなた？
目玉？	目玉？	目玉？	目玉？
知らないよおそんなの	知らないよおそんなの	知らないよおそんなの	知らないよおそんなの
ほんとう？	ほんとう？	ほんとう？	ほんとう？
でも目玉かあ	でも目玉かあ	でも目玉かあ	でも目玉かあ
見せてくれよ	見せてくれよ	見せてくれよ	見せてくれよ
うん	うん	いいよ	いいよ
グシグシグシ	グシグシグシ	グシグシグシ	グシグシグシ
ほら、磨いたぞ！	ほら、磨いたぞ！	ほら、磨いたぞ！	ほら、磨いたぞ！
えぇ	えぇ	えぇ	えぇ
この目玉誰から引っこ抜いたんだろうなあ	この目玉誰から引っこ抜いたんだろうなあ	この目玉誰から引っこ抜いたんだろうなあ	この目玉誰から引っこ抜いたんだろうなあ
......	......	......	......
どこかで見たんだけどなあ	どこかで見たんだけどなあ	どこかで見たんだけどなあ	どこかで見たんだけどなあ
......	......	......	......
斧をとる/とらない	斧をとる/とらない	斧をとる/とらない	斧をとる/とらない
一応ね	一応ね	一応ね	一応ね
ねんのため......	ねんのため......	ねんのため......	ねんのため......
わたしわるいひとかも......	わたしわるいひとかも......	わたしわるいひとかも......	わたしわるいひとかも......
いばりんぼで	いばりんぼで	いばりんぼで	いばりんぼで
......	......	......	......
うわ！	うわ！	うわ！	うわ！
ねえ！	ねえ！	ねえ！	ねえ！
なにか変よ！	なにか変よ！	なにか変よ！	なにか変よ！
お姉ちゃんは死んだのに	お姉ちゃんは死んだのに	お姉ちゃんは死んだのに	お姉ちゃんは死んだのに
なにか変なの！	なにか変なの！	なにか変なの！	なにか変なの！
なんで死んだと思うのかしら	なんで死んだと思うのかしら	なんで死んだと思うのかしら	なんで死んだと思うのかしら
わたしが殺したからよ！	わたしが殺したからよ！	わたしが殺したからよ！	わたしが殺したからよ！
こいしさま	こいしさま	こいしさま	こいしさま
なに	なに	なに	なに
だいじょうぶですよ	だいじょうぶですよ	だいじょうぶですよ	だいじょうぶですよ
これが最後の問題ですから	これが最後の問題ですから	これが最後の問題ですから	これが最後の問題ですから
どういう意味？	どういう意味？	どういう意味？	どういう意味？
色んな意味で	色んな意味で	色んな意味で	色んな意味で
です	です	です	です
みんなをいじめたけどまだ大丈夫ってこと？	みんなをいじめたけどまだ大丈夫ってこと？	みんなをいじめたけどまだ大丈夫ってこと？	みんなをいじめたけどまだ大丈夫ってこと？
にゃー	にゃー	にゃー	にゃー
んがぁー	んがぁー	んがぁー	んがぁー
あ！	あ！	あ！	あ！
かぎ取ってきてくれたの！	かぎ取ってきてくれたの！	かぎ取ってきてくれたの！	かぎ取ってきてくれたの！
やったー！	やったー！	やったー！	やったー！
......	......	......	......
にゃー	にゃー	にゃー	にゃー
友達を助ける/鍵を返す	友達を助ける/鍵を返す	友達を助ける/鍵を返す	友達を助ける/鍵を返す
決めたわ	決めたわ	決めたわ	決めたわ
決めたわ	決めたわ	決めたわ	決めたわ
いま出してあげるわ！	いま出してあげるわ！	いま出してあげるわ！	いま出してあげるわ！
これでいいわ！	これでいいわ！	これでいいわ！	これでいいわ！
でておいで！	でておいで！	でておいで！	でておいで！
ありがとう！	ありがとう！	ありがとう！	ありがとう！
あぶない！	あぶない！	あぶない！	あぶない！
なんなの！？	なんなの！？	なんなの！？	なんなの！？
いたい！	いたい！	いたい！	いたい！
ああああ！	ああああ！	ああああ！	ああああ！
いたい！！	いたい！！	いたい！！	いたい！！
あっあう、ああああ！！	あっあう、ああああ！！	あっあう、ああああ！！	あっあう、ああああ！！
どうしよう	どうしよう	どうしよう	どうしよう
どうしよう	どうしよう	どうしよう	どうしよう
ごめんなさい	ごめんなさい	ごめんなさい	ごめんなさい
ごめんなさい......	ごめんなさい......	ごめんなさい......	ごめんなさい......
やめるわ	やめるわ	やめるわ	やめるわ
にゃー	にゃー	にゃー	にゃー
どうしたの？	どうしたの？	どうしたの？	どうしたの？
ごめんね	ごめんね	ごめんね	ごめんね
お姉ちゃんが決めたことだから	お姉ちゃんが決めたことだから	お姉ちゃんが決めたことだから	お姉ちゃんが決めたことだから
やだあ！	やだあ！	やだあ！	やだあ！
わたしもボールであそぶの！	わたしもボールであそぶの！	わたしもボールであそぶの！	わたしもボールであそぶの！
わたしも友達とお出かけするのお！	わたしも友達とお出かけするのお！	わたしも友達とお出かけするのお！	わたしも友達とお出かけするのお！
ごめんね	ごめんね	ごめんね	ごめんね
でもいまのあなたには	でもいまのあなたには	でもいまのあなたには	でもいまのあなたには
外は危ないの	外は危ないの	外は危ないの	外は危ないの
”わたしたち”ちゃんと練習してから外に出なきゃ......	”わたしたち”ちゃんと練習してから外に出なきゃ......	”わたしたち”ちゃんと練習してから外に出なきゃ......	”わたしたち”ちゃんと練習してから外に出なきゃ......
大丈夫だよ	大丈夫だよ	大丈夫だよ	大丈夫だよ
わたしが遊びに来てあげるから	わたしが遊びに来てあげるから	わたしが遊びに来てあげるから	わたしが遊びに来てあげるから
ぐわぁ......	ぐわぁ......	ぐわぁ......	ぐわぁ......
こっちへ	こっちへ	こっちへ	こっちへ
......	......	......	......
ごめんね	ごめんね	ごめんね	ごめんね
ありがとう、こいし	ありがとう、こいし	ありがとう、こいし	ありがとう、こいし
みんなもありがとう	みんなもありがとう	みんなもありがとう	みんなもありがとう
あなたも	あなたも	あなたも	あなたも
あの子に付き合ってくれてありがとう	あの子に付き合ってくれてありがとう	あの子に付き合ってくれてありがとう	あの子に付き合ってくれてありがとう
あーっ	あーっ	あーっ	あーっ
鳥さん捕まってる！	鳥さん捕まってる！	鳥さん捕まってる！	鳥さん捕まってる！
ピチチチ	ピチチチ	ピチチチ	ピチチチ
誰がやったの！	誰がやったの！	誰がやったの！	誰がやったの！
かわいそう	かわいそう	かわいそう	かわいそう
いま出してあげるね！	いま出してあげるね！	いま出してあげるね！	いま出してあげるね！
んにゃ	んにゃ	んにゃ	んにゃ
お外がいちばんだよね！	お外がいちばんだよね！	お外がいちばんだよね！	お外がいちばんだよね！
ピピッ、ピピピッ！	ピピッ、ピピピッ！	ピピッ、ピピピッ！	ピピッ、ピピピッ！
......	......	......	......
お出かけよ！	お散歩に行きましょ	お散歩に行きましょ	でかけてきまーす！
ぼうし！	ぼうし！	ぼうし！	帽子もね！
ォギャーッ	ォギャーッ	ォギャーッ	ォギャーッ
なに！？	えっ	えっ	なにかしら......
ギャーッ	ギャーッ	ギャーッ	ギャーッ
ア゛ー	なにこれ！	なにこれ！	きもちわるい！
なにあれ	なんだったの	なんだったの	なんだったの
ア˝ー！	ア˝ー！	ア˝ー！	ア˝ー！
こわい	こわい	こわい	こわい
赤ちゃんなんていらない	赤ちゃんなんていらない	赤ちゃんなんていらない	赤ちゃんなんて嫌い
遊びにいこっと	遊びにいこっと	遊びにいこっと	誰もいないの？
なにここ	どこだ	どこだ	帰りたいんだけど
なにこれ	......	......	......
......	......	......	......
一体どうなってるんだ！	一体どうなってるんだ！	一体どうなってるんだ！	一体どうなってるんだ！
あんなに大きいのに可阿呆はまだ喋らないぞ	あんなに大きいのに可阿呆はまだ喋らないぞ	あんなに大きいのに可阿呆はまだ喋らないぞ	あんなに大きいのに可阿呆はまだ喋らないぞ
ちゃんと面倒みてるのか	ちゃんと面倒みてるのか	ちゃんと面倒みてるのか	ちゃんと面倒みてるのか
そんな	そんな	そんな	そんな
私は精一杯――	私は精一杯――	私は精一杯――	私は精一杯――
育て方が正しいのなら生まれが悪いんだろう	育て方が正しいのなら生まれが悪いんだろう	育て方が正しいのなら生まれが悪いんだろう	育て方が正しいのなら生まれが悪いんだろう
本当に禁酒できていたんだろうな	本当に禁酒できていたんだろうな	本当に禁酒できていたんだろうな	本当に禁酒できていたんだろうな
何をおっしゃるのです	何をおっしゃるのです	何をおっしゃるのです	何をおっしゃるのです
ずっと留守にして家の様子なんてご存じないでしょう	ずっと留守にして家の様子なんてご存じないでしょう	ずっと留守にして家の様子なんてご存じないでしょう	ずっと留守にして家の様子なんてご存じないでしょう
何を根拠に――	何を根拠に――	何を根拠に――	何を根拠に――
ふん、どうかな	ふん、どうかな	ふん、どうかな	ふん、どうかな
うちの家は全員秀才揃いなんだ	うちの家は全員秀才揃いなんだ	うちの家は全員秀才揃いなんだ	うちの家は全員秀才揃いなんだ
私は３歳で福音書を暗唱できたのに	私は３歳で福音書を暗唱できたのに	私は３歳で福音書を暗唱できたのに	私は３歳で福音書を暗唱できたのに
こいつはだんまりだ	こいつはだんまりだ	こいつはだんまりだ	こいつはだんまりだ
みなさん利発そうだとほめてくださいます	みなさん利発そうだとほめてくださいます	みなさん利発そうだとほめてくださいます	みなさん利発そうだとほめてくださいます
社交辞令だよバカ	社交辞令だよバカ	社交辞令だよバカ	社交辞令だよバカ
気を使われてるんだよ	気を使われてるんだよ	気を使われてるんだよ	気を使われてるんだよ
そんな	そんな	そんな	そんな
私、良妻を務めてきました	私、良妻を務めてきました	私、良妻を務めてきました	私、良妻を務めてきました
ああそうだろう	ああそうだろう	ああそうだろう	ああそうだろう
だが母親失格だ	だが母親失格だ	だが母親失格だ	だが母親失格だ
だってあたし、双子が生まれるだなんて	だってあたし、双子が生まれるだなんて	だってあたし、双子が生まれるだなんて	だってあたし、双子が生まれるだなんて
それも関係ない	それも関係ない	それも関係ない	それも関係ない
それから、田舎臭い言葉も控えなさい	それから、田舎臭い言葉も控えなさい	それから、田舎臭い言葉も控えなさい	それから、田舎臭い言葉も控えなさい
来月、弟が訪ねてくる	来月、弟が訪ねてくる	来月、弟が訪ねてくる	来月、弟が訪ねてくる
息子を連れてな	息子を連れてな	息子を連れてな	息子を連れてな
男を産めないならせめてまともな娘を育ててくれ	男を産めないならせめてまともな娘を育ててくれ	男を産めないならせめてまともな娘を育ててくれ	男を産めないならせめてまともな娘を育ててくれ
それができないなら話せないやつは顔を出させるな	それができないなら話せないやつは顔を出させるな	それができないなら話せないやつは顔を出させるな	それができないなら話せないやつは顔を出させるな
わかりました......	わかりました......	わかりました......	わかりました......
ママ？	ママ？	ママ？	ママ？
目薬だ	目薬だ	目薬だ	薬だわ
もらお	もらお	もらお	しまっておきましょ
あ゛あ゛あ゛あ゛あ゛あ゛あ゛あ゛あ゛	あ゛あ゛あ゛あ゛あ゛あ゛あ゛あ゛あ゛	あ゛あ゛あ゛あ゛あ゛あ゛あ゛あ゛あ゛	あ゛あ゛あ゛あ゛あ゛あ゛あ゛あ゛あ゛
いや！	いや！	いや！	なに？
”赤ん坊なんて嫌い！”	”赤ん坊なんて嫌い！”	”赤ん坊なんて嫌い！”	どうして泣いているの
”あっちいって！”	”あっちいって！”	”あっちいって！”	お目目が痛いの？
”嫌！”	”嫌！”	”嫌！”	大丈夫よ
あ゛あ゛あ゛あ゛あ゛あ゛あ゛あ゛あ゛	あ゛あ゛あ゛あ゛あ゛あ゛あ゛あ゛あ゛	あ゛あ゛あ゛あ゛あ゛あ゛あ゛あ゛あ゛	あ゛あ゛あ゛あ゛あ゛あ゛あ゛あ゛あ゛
あたしを見ないで！	あたしを見ないで！	あたしを見ないで！	私が助けてあげる！
いや！	いや！	いや！	いや！
そんな目で見ないで！	そんな目で見ないで！	そんな目で見ないで！	そんな目で見ないで！
あたしが悪いの？	あたしが悪いの？	あたしが悪いの？	あたしが悪いの？
あっちいけ！	あっちいけ！	あっちいけ！	あっちいけ！
いえ、	いえ、	いえ、	いえ、
ちがうわ！	ちがうわ！	ちがうわ！	ちがうわ！
あなたよ！	あなたよ！	あなたよ！	あなたよ！
あなたが悪いのよ！	あなたが悪いのよ！	あなたが悪いのよ！	あなたが悪いのよ！
あ゛あ゛あ゛あ゛あ゛あ゛あ゛あ゛あ゛	あ゛あ゛あ゛あ゛あ゛あ゛あ゛あ゛あ゛	あ゛あ゛あ゛あ゛あ゛あ゛あ゛あ゛あ゛	いや！
----	----	----	私はいや！
ここどこ！？	ここどこ！？	ここどこ！？	ここは？
はやく逃げなきゃ！	はやく逃げなきゃ！	はやく逃げなきゃ！	あの子を助けてあげないと
こわい！	こわい！	こわい！	どうしよう
誰か呼ばなきゃ	誰か呼ばなきゃ	誰か呼ばなきゃ	急がなきゃ
こんなのさわってるばあいじゃない！	こんなのさわってるばあいじゃない！	こんなのさわってるばあいじゃない！	遊びたいけれど今はダメだわ
”ばか！”	”ばか！”	”ばか！”	うーん
なにかないかな	なにかないかな	なにかないかな	お薬ないかな
包丁とか......	包丁とか......	包丁とか......	ないな......
......	......	......	”なにもない”しかない
なにもない！	なにもない！	なにもない！	早くしなきゃ
あ゛あ゛あ゛あ゛あ゛あ゛あ゛あ゛あ゛	あ゛あ゛あ゛あ゛あ゛あ゛あ゛あ゛あ゛	あ゛あ゛あ゛あ゛あ゛あ゛あ゛あ゛あ゛	あ゛あ゛あ゛あ゛あ゛あ゛あ゛あ゛あ゛
......	......	......	電話なら誰か呼べる！
こいつ動かない！	こいつ動かない！	こいつ動かない！	でも動かない！
ｼﾞﾘﾘﾘﾘﾘﾘﾘ!!!!	ｼﾞﾘﾘﾘﾘﾘﾘﾘ!!!!	ｼﾞﾘﾘﾘﾘﾘﾘﾘ!!!!	ｼﾞﾘﾘﾘﾘﾘﾘﾘ!!!!
うわ！	うわ！	うわ！	電話よ！
やめて！	やめて！	やめて！	誰？
こいし？	こいし？	こいし？	こいし？
あなたなのね？	あなたなのね？	あなたなのね？	あなたなのね？
誰よ！	誰よ！	誰よ！	この声―-
あ゛あ゛あ゛あ゛あ゛あ゛あ゛あ゛あ゛	あ゛あ゛あ゛あ゛あ゛あ゛あ゛あ゛あ゛	あ゛あ゛あ゛あ゛あ゛あ゛あ゛あ゛あ゛	あ゛あ゛あ゛あ゛あ゛あ゛あ゛あ゛あ゛
いや！	いや！	いや！	大丈夫？
こないで	こないで	こないで	いま友達呼ぶから！
さとり	さとり	さとり	さとり
お前はいいこだ	お前はいいこだ	お前はいいこだ	お前はいいこだ
賢い	賢い	賢い	賢い
かわいい	かわいい	かわいい	かわいい
満点だってお前には不満だろう	満点だってお前には不満だろう	満点だってお前には不満だろう	満点だってお前には不満だろう
それにひきかえお前は母親に似てしまったな	それにひきかえお前は母親に似てしまったな	それにひきかえお前は母親に似てしまったな	それにひきかえお前は母親に似てしまったな
こいつは閉じ込めておくんだ	こいつは閉じ込めておくんだ	こいつは閉じ込めておくんだ	こいつは閉じ込めておくんだ
入院中だと言えばいい	入院中だと言えばいい	入院中だと言えばいい	入院中だと言えばいい
どうせ口はきけん！	どうせ口はきけん！	どうせ口はきけん！	どうせ口はきけん！
さとりにはおめかしさせてから広間へ来るんだ	さとりにはおめかしさせてから広間へ来るんだ	さとりにはおめかしさせてから広間へ来るんだ	さとりにはおめかしさせてから広間へ来るんだ
なんなの！	なんなの！	なんなの！	なんなの！
なにかしら	なにかしら	なにかしら	なにかしら
......	......	......	......
あ˝あ˝あ˝あ˝あ˝あ˝あ˝あ˝あ˝あ˝あ˝あ˝	あ˝あ˝あ˝あ˝あ˝あ˝あ˝あ˝あ˝あ˝あ˝あ˝	あ˝あ˝あ˝あ˝あ˝あ˝あ˝あ˝あ˝あ˝あ˝あ˝	あ˝あ˝あ˝あ˝あ˝あ˝あ˝あ˝あ˝あ˝あ˝あ˝
......	......	......	......
あぶあぶあぶ	あぶあぶあぶ	あぶあぶあぶ	あぶあぶあぶ
......	......	......	......
ぶあー！！	ぶあー！！	ぶあー！！	ぶあー！！
......	......	......	......
ﾌﾞﾌﾞﾌﾞ	ﾌﾞﾌﾞﾌﾞ	ﾌﾞﾌﾞﾌﾞ	ﾌﾞﾌﾞﾌﾞ
......	......	......	......
静かにしなさい	静かにしなさい	静かにしなさい	静かにしなさい
あば	あば	あば	あば
ぶぶぶー	ぶぶぶー	ぶぶぶー	ぶぶぶー
しずかにして！	しずかにして！	しずかにして！	しずかにして！
私は悪くないのに！	私は悪くないのに！	私は悪くないのに！	私は悪くないのに！
う	う	う	う
あ˝あ˝	あ˝あ˝	あ˝あ˝	あ˝あ˝
あ˝あ˝あ˝あ˝あ˝あ˝あ˝あ˝あ˝あ˝あ˝あ˝	あ˝あ˝あ˝あ˝あ˝あ˝あ˝あ˝あ˝あ˝あ˝あ˝	あ˝あ˝あ˝あ˝あ˝あ˝あ˝あ˝あ˝あ˝あ˝あ˝	あ˝あ˝あ˝あ˝あ˝あ˝あ˝あ˝あ˝あ˝あ˝あ˝
ううう	ううう	ううう	ううう
誰が悪いのかしら	誰が悪いのかしら	誰が悪いのかしら	誰が悪いのかしら
目が回ってきた	目が回ってきた	目が回ってきた	目が回ってきた
やあ	やあ	やあ	やあ
なに	なに	なに	こんにちは
ここまで旅してきてどうだった？	ここまで旅してきてどうだった？	ここまで旅してきてどうだった？	ここまで旅してきてどうだった？
どういうこと？	どういうこと？	どういうこと？	どういうこと？
人生はチョコレートの箱	人生はチョコレートの箱	人生はチョコレートの箱	人生はチョコレートの箱
どんな素敵なものが詰まっているか――	どんな素敵なものが詰まっているか――	どんな素敵なものが詰まっているか――	どんな素敵なものが詰まっているか――
開けなければわからない	開けなければわからない	開けなければわからない	開けなければわからない
ぜんぜんわかんないんだけど	ぜんぜんわかんないんだけど	ぜんぜんわかんないんだけど	......そうかしら
君は早く”目を開けて”中身を見ないとね	君は早く”目を開けて”中身を見ないとね	君は早く”目を開けて”中身を見ないとね	君は早く”目を開けて”中身を見ないとね
僕を開けて！	僕を開けて！	僕を開けて！	僕を開けて！
はさみ！	はさみ！	はさみ！	はさみ！
いい武器！	いい武器！	いい武器！	はさみでなにをしたらいいのかしら
チョコレートさんありがとう！	チョコレートさんありがとう！	チョコレートさんありがとう！	......
へへへ	へへへ	へへへ	自分で考えなきゃダメ？
あぶぶぶ	あぶぶぶ	あぶぶぶ	あぶぶぶ
！	！	！	！
こいし！	こいし！	こいし！	こいし！
こいし......	こいし......	こいし......	こいし......
私達には私達しか......	私達には私達しか......	私達には私達しか......	私達には私達しか......
お願い起きて	お願い起きて	お願い起きて	お願い起きて
うー	うー	うー	うー
あたまいてて	あたまいてて	あたまいてて	頭が痛いわ
なにあれ	なにあれ	なにあれ	ちいさいこどもがいる
気持ち悪い	気持ち悪い	気持ち悪い	みんなどこいくの！
なにしてるの	なにしてるの	なにしてるの	なにやってるんだろう
そとだ！	そとだ！	そとだ！	そとだ！
あかりだ	あかりだ	あかりだ	あかるい......
なにこれ	なにこれ	なにこれ	なにこれ
気持ち悪い	気持ち悪い	気持ち悪い	気持ち悪い
あばぶ	あばぶ	あばぶ	あばぶ
わたしはどうしたらいいの	わたしはどうしたらいいの	わたしはどうしたらいいの	わたしはどうしたらいいの
ちょっと待って	ちょっと待って	ちょっと待って	ちょっと待って
待ってよ	待ってよ	待ってよ	待ってよ
待ってってば	待ってってば	待ってってば	待ってってば
私決めたの！	私決めたの！	私決めたの！	私決めたの！
わたしのことは自分で決めるわ	わたしのことは自分で決めるわ	わたしのことは自分で決めるわ	わたしのことは自分で決めるわ
あなたが眠っている間にいろんなことがあったわ	あなたが眠っている間にいろんなことがあったわ	あなたが眠っている間にいろんなことがあったわ	あなたが眠っている間にいろんなことがあったわ
そうなの	そうなの	そうなの	そうなの
山のほうからお客さんが来たり	山のほうからお客さんが来たり	山のほうからお客さんが来たり	山のほうからお客さんが来たり
街道のほうもにぎやかになったりね	街道のほうもにぎやかになったりね	街道のほうもにぎやかになったりね	街道のほうもにぎやかになったりね
ふうん	ふうん	ふうん	ふうん
いいね	いいね	いいね	いいね
さとりさまーっ	さとりさまーっ	さとりさまーっ	さとりさまーっ
さとりさまーっお客様ですーっ	さとりさまーっお客様ですーっ	さとりさまーっお客様ですーっ	さとりさまーっお客様ですーっ
またお山のお客さんね	またお山のお客さんね	またお山のお客さんね	またお山のお客さんね
いいお話を持ってきてくれるんだけど	いいお話を持ってきてくれるんだけど	いいお話を持ってきてくれるんだけど	いいお話を持ってきてくれるんだけど
あなたがいてくれるし	あなたがいてくれるし	あなたがいてくれるし	あなたがいてくれるし
あの子たちのことも気になるし	あの子たちのことも気になるし	あの子たちのことも気になるし	あの子たちのことも気になるし
お断りしなくちゃ	お断りしなくちゃ	お断りしなくちゃ	お断りしなくちゃ
ちょっと行ってくるわね	ちょっと行ってくるわね	ちょっと行ってくるわね	ちょっと行ってくるわね
うん	うん	うん	うん
わたしの気持ちが伝わってうれしいわ	わたしの気持ちが伝わってうれしいわ	わたしの気持ちが伝わってうれしいわ	わたしの気持ちが伝わってうれしいわ
うふふ	うふふ	うふふ	うふふ
あきらめなくてよかったわ	あきらめなくてよかったわ	あきらめなくてよかったわ	あきらめなくてよかったわ
ふーっ	ふーっ	ふーっ	ふーっ
家族って大変	家族って大変	家族って大変	家族って大変
でも頑張んなきゃ	でも頑張んなきゃ	でも頑張んなきゃ	でも頑張んなきゃ
周りの目――	周りの目――	周りの目――	周りの目――
第三の目もあるからね	第三の目もあるからね	第三の目もあるからね	第三の目もあるからね
あは！	あは！	あは！	あは！
うう	うう	うう	うう
なにこれ	なにこれ	なにこれ	なにこれ
えっと	えっと	えっと	えっと
ねえ！	ねえ！	ねえ！	ねえ！
だれか！	だれか！	だれか！	だれか！
ねえこいし	ねえこいし	ねえこいし	ねえこいし
聞こえてるんでしょう	聞こえてるんでしょう	聞こえてるんでしょう	聞こえてるんでしょう
どうして起きてくれないの？	どうして起きてくれないの？	どうして起きてくれないの？	どうして起きてくれないの？
私何かいけなかったの？	私何かいけなかったの？	私何かいけなかったの？	私何かいけなかったの？
あなたが悪いのよ	あなたが悪いのよ	あなたが悪いのよ	あなたが悪いのよ
私が導いてあげたのに	私が導いてあげたのに	私が導いてあげたのに	私が導いてあげたのに
失敗ばっかりして！	失敗ばっかりして！	失敗ばっかりして！	失敗ばっかりして！
私を困らせないで......	私を困らせないで......	私を困らせないで......	私を困らせないで......
あ゛あ゛	あ゛あ゛	あ゛あ゛	あ゛あ゛
もういや！	もういや！	もういや！	もういや！
あ゛あ゛	あ゛あ゛	あ゛あ゛	あ゛あ゛
うるさい！	うるさい！	うるさい！	うるさい！
やめなさいこいし！	やめなさいこいし！	やめなさいこいし！	やめなさいこいし！
わたしはやりたいようにやるわ！	わたしはやりたいようにやるわ！	わたしはやりたいようにやるわ！	わたしはやりたいようにやるわ！
あ゛	あ゛	あ゛	あ゛
これでいいわ	これでいいわ	これでいいわ	これでいいわ
これで	これで	これで	これで
第三者の目(できたら”3rdeye”にルビかけ)とは関係なくなる	第三者の目(できたら”3rdeye”にルビかけ)とは関係なくなる	第三者の目(できたら”3rdeye”にルビかけ)とは関係なくなる	第三者の目(できたら”3rdeye”にルビかけ)とは関係なくなる
あはは！	あはは！	あはは！	あはは！
もうなにも考えなくていいんだわ！	もうなにも考えなくていいんだわ！	もうなにも考えなくていいんだわ！	もうなにも考えなくていいんだわ！
あははは！	あははは！	あははは！	あははは！
ばいばーい	ばいばーい	ばいばーい	ばいばーい
バアアアア！！	バアアアア！！	バアアアア！！	バアアアア！！
嫌！	嫌！	嫌！	嫌！
こないで！	こないで！	こないで！	こないで！
私悪くないでしょ！	私悪くないでしょ！	私悪くないでしょ！	私悪くないでしょ！
まだねむたくないもん	まだねむたくないもん	まだねむたくないもん	まだねむたくないもん
にっきさんひさしぶり！またね！	にっきさんひさしぶり！またね！	にっきさんひさしぶり！またね！	にっきさんひさしぶり！またね！
くれおん！	くれおん！	くれおん！	くれおん！
もうピンクない	もうピンクない	もうピンクない	もうピンクない
なにかいる！	なにかいる！	なにかいる！	なにかいる！
あけない	あけない	あけない	あけない
ここジョンのばしょ！	ここジョンのばしょ！	ここジョンのばしょ！	ここジョンのばしょ！
いいこいいこ！	いいこいいこ！	いいこいいこ！	いいこいいこ！
ばいばい	ばいばい	ばいばい	ばいばい
これはかびん……おおきいから	これはかびん……おおきいから	これはかびん……おおきいから	これはかびん……おおきいから
かびん！	かびん！	かびん！	かびん！
さっきのこいないなー	さっきのこいないなー	さっきのこいないなー	さっきのこいないなー
このはっぱ、えがかけるよ	このはっぱ、えがかけるよ	このはっぱ、えがかけるよ	このはっぱ、えがかけるよ
まぶしい	まぶしい	まぶしい	まぶしい
これうるさいからきらい	これうるさいからきらい	これうるさいからきらい	これうるさいからきらい
あとでのろっと	あとでのろっと	あとでのろっと	あとでのろっと
だれかとって！	だれかとって！	だれかとって！	だれかとって！
いまはかくれんぼしてないからあとでね！	いまはかくれんぼしてないからあとでね！	いまはかくれんぼしてないからあとでね！	いまはかくれんぼしてないからあとでね！
あしおれたらのってもいい？	あしおれたらのってもいい？	あしおれたらのってもいい？	あしおれたらのってもいい？
へんなベッド	へんなベッド	へんなベッド	へんなベッド
くすりはいらない……	くすりはいらない……	くすりはいらない……	くすりはいらない……
くーくーばこ！けがしてないよ！	くーくーばこ！けがしてないよ！	くーくーばこ！けがしてないよ！	くーくーばこ！けがしてないよ！
やだやだ。	やだやだ。	やだやだ。	やだやだ。
ばんこーそー？	ばんこーそー？	ばんこーそー？	ばんこーそー？
ナイフ	ナイフ	ナイフ	ナイフ
くすぐったーい！	くすぐったーい！	くすぐったーい！	くすぐったーい！
だれかじゅんびちゅう？	だれかじゅんびちゅう？	だれかじゅんびちゅう？	だれかじゅんびちゅう？
こーえん？	こーえん？	こーえん？	こーえん？
いってもいいかな	いってもいいかな	いってもいいかな	いってもいいかな
まっていればいいのかな	まっていればいいのかな	まっていればいいのかな	まっていればいいのかな
まだかなー	まだかなー	まだかなー	まだかなー
こない	こない	こない	こない
からっぽ！	からっぽ！	からっぽ！	からっぽ！
わかんない	わかんない	わかんない	わかんない
くすぐったいやつ	くすぐったいやつ	くすぐったいやつ	くすぐったいやつ
これさわるといろがかわるんだよ！	これさわるといろがかわるんだよ！	これさわるといろがかわるんだよ！	これさわるといろがかわるんだよ！
おつきさまとれるかな	おつきさまとれるかな	おつきさまとれるかな	おつきさまとれるかな
みっけ！	みっけ！	みっけ！	みっけ！
がさがさ！	がさがさ！	がさがさ！	がさがさ！
ざわざわ！	ざわざわ！	ざわざわ！	ざわざわ！
ピンク色が欲しいな	今度の贈り物は色鉛筆がいい	今度の贈り物は色鉛筆がいい	今度の贈り物は色鉛筆がいい
真っ白だわ！	真っ白だわ！	真っ白だわ！	真っ白だわ！
まだしまっとこっと	まだしまっとこっと	まだしまっとこっと	まだしまっとこっと
ジョン、出てこないの？	ジョンがいない	ジョンがいない	ジョンがいない
寒いもんね	日向に行ったのかな	日向に行ったのかな	日向に行ったのかな
風邪じゃないよ！	風邪ひいたらここね！	風邪ひいたらここね！	風邪ひいたらここね！
お薬のみたくないから	今はいらないよ！	今はいらないよ！	今はいらないよ！
けがしたらここ！	いまはだいじょうぶ！	いまはだいじょうぶ！	いまはだいじょうぶ！
ナイフ	ナイフだ	ナイフだ	ナイフだ
雪の中で乗ったらすごいんじゃない？	雪の中で乗ったらすごいんじゃない？	雪の中で乗ったらすごいんじゃない？	雪の中で乗ったらすごいんじゃない？
きらいだけどきなきゃだめ？	寒いから履いたほうがいいと思う/またこんど、ね	寒いから履いたほうがいいと思う/またこんど、ね	寒いから履いたほうがいいと思う/またこんど、ね
これだれの？	誰が置いたの？	誰が置いたの？	誰が置いたの？
まぶしい	ギラギラする	ギラギラする	ギラギラする
お外で走りたいなー	だれがくれたんだっけ...	だれがくれたんだっけ...	だれがくれたんだっけ...
いまはかくれんぼしてないからあとでね！	いまはかくれんぼしてないからあとでね！	いまはかくれんぼしてないからあとでね！	いまはかくれんぼしてないからあとでね！
ほこりだらけ！	ほこりだらけ！	ほこりだらけ！	ほこりだらけ！
だれかとって！	だれかとって！	だれかとって！	だれかとって！
あれ？	おかしいな	おかしいな	おかしいな
動いてないな	なんで動いてないんだろう？	なんで動いてないんだろう？	なんで動いてないんだろう？
寝ちゃったの？	お姉ちゃんがネジ巻き忘れたのかな	お姉ちゃんがネジ巻き忘れたのかな	お姉ちゃんがネジ巻き忘れたのかな
つめたい！	ひんやりしてる！	ひんやりしてる！	ひんやりしてる！
これもつめたい！	へんなかびんだなー	へんなかびんだなー	へんなかびんだなー
こっちも冷たい！	ちゃんとしたかびんね！	ちゃんとしたかびんね！	ちゃんとしたかびんね！
くすぐったーい！	くすぐったーい！	くすぐったーい！	くすぐったーい！
だれかじゅんびちゅう？	だれかじゅんびちゅう？	だれかじゅんびちゅう？	だれかじゅんびちゅう？
あーあ	あとでなおさなきゃ	あとでなおさなきゃ	あとでなおさなきゃ
まだ生きてるのに変なの	誰のお墓かしら	誰のお墓かしら	誰のお墓かしら
誰？	あの子のことかな	あの子のことかな	あの子のことかな
わーっ、ジョン！	いままでどこにいたのかしら！	いままでどこにいたのかしら！	いままでどこにいたのかしら！
冷たい！	冷たそう	冷たそう	冷たそう
きれい！	立派なお墓ね！	立派なお墓ね！	立派なお墓ね！
おえーっ	なんかくさい	なんかくさい	なんかくさい
この子へんてこ！	彼女たぶん変わってる	彼女たぶん変わってる	彼女たぶん変わってる
先生かな	きっと先生ね	きっと先生ね	きっと先生ね
強そう！	すごく強い！	すごく強い！	すごく強い！
へんなの	これ死体？	これ死体？	これ死体？
おもちゃいーなー	お姉ちゃんにもらったのかな	お姉ちゃんにもらったのかな	お姉ちゃんにもらったのかな
わたしもこうゆうのほしいな...	私もほしいな	私もほしいな	私もほしいな
きれい！	うちでもやりたいな	うちでもやりたいな	うちでもやりたいな
「とっととやれ！」	「もたもたしてんじゃない！」	「もたもたしてんじゃない！」	「もたもたしてんじゃない！」
